Year,Ymd,AAVSO,AMERICAN,Difference,Percent
1946,1946-12-30,106,117,-11,-9.4
1947,1947-01-11,139,135,4,2.96
1947,1947-01-12,160,163,-3,-1.84
1947,1947-01-18,206,240,-34,-14.17
1947,1947-01-25,120,152,-32,-21.05
1947,1947-01-26,93,117,-24,-20.51
1947,1947-02-01,69,75,-6,-8
1947,1947-02-02,94,88,6,6.82
1947,1947-02-08,135,146,-11,-7.53
1947,1947-02-09,154,157,-3,-1.91
1947,1947-02-12,163,193,-30,-15.54
1947,1947-02-16,163,173,-10,-5.78
1947,1947-02-23,125,124,1,0.81
1947,1947-02-24,118,141,-23,-16.31
1947,1947-03-04,168,189,-21,-11.11
1947,1947-03-05,221,224,-3,-1.34
1947,1947-03-06,189,236,-47,-19.92
1947,1947-03-07,220,223,-3,-1.35
1947,1947-03-09,242,212,30,14.15
1947,1947-03-12,198,207,-9,-4.35
1947,1947-03-13,213,180,33,18.33
1947,1947-03-15,134,125,9,7.2
1947,1947-03-16,96,92,4,4.35
1947,1947-03-17,82,67,15,22.39
1947,1947-03-18,72,60,12,20
1947,1947-03-19,61,53,8,15.09
1947,1947-03-20,62,71,-9,-12.68
1947,1947-03-21,111,90,21,23.33
1947,1947-03-25,111,114,-3,-2.63
1947,1947-03-26,155,139,16,11.51
1947,1947-03-27,167,166,1,0.6
1947,1947-03-28,157,186,-29,-15.59
1947,1947-03-29,218,189,29,15.34
1947,1947-03-30,200,206,-6,-2.91
1947,1947-03-31,218,215,3,1.4
1947,1947-04-04,204,196,8,4.08
1947,1947-04-06,241,222,19,8.56
1947,1947-04-08,219,203,16,7.88
1947,1947-04-09,199,198,1,0.51
1947,1947-04-12,141,122,19,15.57
1947,1947-04-13,119,112,7,6.25
1947,1947-04-15,68,71,-3,-4.23
1947,1947-04-18,84,94,-10,-10.64
1947,1947-04-19,92,97,-5,-5.15
1947,1947-04-22,88,96,-8,-8.33
1947,1947-04-26,242,219,23,10.5
1947,1947-04-27,174,209,-35,-16.75
1947,1947-04-28,181,215,-34,-15.81
1947,1947-04-29,160,209,-49,-23.44
1947,1947-04-30,170,208,-38,-18.27
1947,1947-05-01,218,211,7,3.32
1947,1947-05-02,113,191,-78,-40.84
1947,1947-05-04,226,197,29,14.72
1947,1947-05-06,167,173,-6,-3.47
1947,1947-05-07,141,178,-37,-20.79
1947,1947-05-08,158,173,-15,-8.67
1947,1947-05-09,145,163,-18,-11.04
1947,1947-05-10,167,181,-14,-7.73
1947,1947-05-11,155,178,-23,-12.92
1947,1947-05-12,163,176,-13,-7.39
1947,1947-05-13,100,175,-75,-42.86
1947,1947-05-15,121,126,-5,-3.97
1947,1947-05-16,132,147,-15,-10.2
1947,1947-05-17,156,171,-15,-8.77
1947,1947-05-18,171,190,-19,-10
1947,1947-05-19,306,246,60,24.39
1947,1947-05-20,195,261,-66,-25.29
1947,1947-05-21,94,282,-188,-66.67
1947,1947-05-23,401,368,33,8.97
1947,1947-05-24,341,363,-22,-6.06
1947,1947-05-25,256,341,-85,-24.93
1947,1947-05-26,290,324,-34,-10.49
1947,1947-05-27,295,285,10,3.51
1947,1947-05-28,249,294,-45,-15.31
1947,1947-05-29,263,276,-13,-4.71
1947,1947-05-30,211,224,-13,-5.8
1947,1947-05-31,209,234,-25,-10.68
1947,1947-06-01,160,205,-45,-21.95
1947,1947-06-02,179,174,5,2.87
1947,1947-06-03,135,137,-2,-1.46
1947,1947-06-04,106,136,-30,-22.06
1947,1947-06-05,107,140,-33,-23.57
1947,1947-06-06,141,162,-21,-12.96
1947,1947-06-07,164,169,-5,-2.96
1947,1947-06-08,96,118,-22,-18.64
1947,1947-06-09,77,97,-20,-20.62
1947,1947-06-10,81,108,-27,-25
1947,1947-06-11,116,101,15,14.85
1947,1947-06-12,102,96,6,6.25
1947,1947-06-13,84,86,-2,-2.33
1947,1947-06-14,83,95,-12,-12.63
1947,1947-06-15,113,140,-27,-19.29
1947,1947-06-16,144,152,-8,-5.26
1947,1947-06-17,213,203,10,4.93
1947,1947-06-18,186,239,-53,-22.18
1947,1947-06-19,342,268,74,27.61
1947,1947-06-21,192,255,-63,-24.71
1947,1947-06-22,224,256,-32,-12.5
1947,1947-06-23,244,241,3,1.24
1947,1947-06-25,115,177,-62,-35.03
1947,1947-06-26,59,149,-90,-60.4
1947,1947-06-27,140,150,-10,-6.67
1947,1947-06-28,106,137,-31,-22.63
1947,1947-06-29,171,167,4,2.4
1947,1947-06-30,167,172,-5,-2.91
1947,1947-07-01,148,173,-25,-14.45
1947,1947-07-02,118,144,-26,-18.06
1947,1947-07-03,108,137,-29,-21.17
1947,1947-07-04,122,141,-19,-13.48
1947,1947-07-05,131,136,-5,-3.68
1947,1947-07-06,124,143,-19,-13.29
1947,1947-07-07,122,150,-28,-18.67
1947,1947-07-08,147,134,13,9.7
1947,1947-07-09,178,187,-9,-4.81
1947,1947-07-10,158,164,-6,-3.66
1947,1947-07-11,113,140,-27,-19.29
1947,1947-07-12,139,146,-7,-4.79
1947,1947-07-13,169,174,-5,-2.87
1947,1947-07-15,149,192,-43,-22.4
1947,1947-07-16,174,193,-19,-9.84
1947,1947-07-17,156,200,-44,-22
1947,1947-07-18,206,211,-5,-2.37
1947,1947-07-19,171,209,-38,-18.18
1947,1947-07-20,173,207,-34,-16.43
1947,1947-07-21,132,212,-80,-37.74
1947,1947-07-22,111,168,-57,-33.93
1947,1947-07-23,161,170,-9,-5.29
1947,1947-07-24,153,176,-23,-13.07
1947,1947-07-25,168,179,-11,-6.15
1947,1947-07-26,179,174,5,2.87
1947,1947-07-27,160,157,3,1.91
1947,1947-07-28,117,141,-24,-17.02
1947,1947-07-29,111,135,-24,-17.78
1947,1947-07-30,125,150,-25,-16.67
1947,1947-07-31,133,135,-2,-1.48
1947,1947-08-01,165,169,-4,-2.37
1947,1947-08-02,163,199,-36,-18.09
1947,1947-08-03,218,229,-11,-4.8
1947,1947-08-04,203,218,-15,-6.88
1947,1947-08-05,229,230,-1,-0.43
1947,1947-08-06,252,251,1,0.4
1947,1947-08-07,313,300,13,4.33
1947,1947-08-08,285,308,-23,-7.47
1947,1947-08-09,348,338,10,2.96
1947,1947-08-10,329,337,-8,-2.37
1947,1947-08-11,303,334,-31,-9.28
1947,1947-08-12,275,303,-28,-9.24
1947,1947-08-13,318,340,-22,-6.47
1947,1947-08-14,340,338,2,0.59
1947,1947-08-15,285,319,-34,-10.66
1947,1947-08-16,165,242,-77,-31.82
1947,1947-08-17,165,209,-44,-21.05
1947,1947-08-18,160,173,-13,-7.51
1947,1947-08-19,146,151,-5,-3.31
1947,1947-08-20,155,125,30,24
1947,1947-08-21,100,118,-18,-15.25
1947,1947-08-22,115,101,14,13.86
1947,1947-08-23,82,83,-1,-1.2
1947,1947-08-24,107,117,-10,-8.55
1947,1947-08-25,104,111,-7,-6.31
1947,1947-08-26,135,110,25,22.73
1947,1947-08-27,118,138,-20,-14.49
1947,1947-08-29,178,198,-20,-10.1
1947,1947-08-30,169,219,-50,-22.83
1947,1947-08-31,249,243,6,2.47
1947,1947-09-01,253,241,12,4.98
1947,1947-09-03,236,253,-17,-6.72
1947,1947-09-04,283,252,31,12.3
1947,1947-09-05,226,236,-10,-4.24
1947,1947-09-06,302,282,20,7.09
1947,1947-09-07,314,292,22,7.53
1947,1947-09-08,329,283,46,16.25
1947,1947-09-09,243,257,-14,-5.45
1947,1947-09-10,211,229,-18,-7.86
1947,1947-09-11,184,198,-14,-7.07
1947,1947-09-12,210,188,22,11.7
1947,1947-09-13,175,182,-7,-3.85
1947,1947-09-14,174,163,11,6.75
1947,1947-09-16,157,156,1,0.64
1947,1947-09-17,145,164,-19,-11.59
1947,1947-09-18,133,142,-9,-6.34
1947,1947-09-19,108,114,-6,-5.26
1947,1947-09-20,107,115,-8,-6.96
1947,1947-09-21,97,121,-24,-19.83
1947,1947-09-23,119,120,-1,-0.83
1947,1947-09-24,156,141,15,10.64
1947,1947-09-25,183,167,16,9.58
1947,1947-09-26,167,189,-22,-11.64
1947,1947-09-27,176,195,-19,-9.74
1947,1947-09-28,211,195,16,8.21
1947,1947-09-29,213,216,-3,-1.39
1947,1947-09-30,232,248,-16,-6.45
1947,1947-10-01,262,241,21,8.71
1947,1947-10-02,247,271,-24,-8.86
1947,1947-10-03,331,322,9,2.8
1947,1947-10-04,313,324,-11,-3.4
1947,1947-10-05,356,284,72,25.35
1947,1947-10-06,231,229,2,0.87
1947,1947-10-07,154,195,-41,-21.03
1947,1947-10-08,155,191,-36,-18.85
1947,1947-10-09,116,167,-51,-30.54
1947,1947-10-10,177,149,28,18.79
1947,1947-10-11,131,133,-2,-1.5
1947,1947-10-12,97,110,-13,-11.82
1947,1947-10-14,106,103,3,2.91
1947,1947-10-15,122,126,-4,-3.17
1947,1947-10-16,171,152,19,12.5
1947,1947-10-17,154,152,2,1.32
1947,1947-10-18,173,172,1,0.58
1947,1947-10-19,184,164,20,12.2
1947,1947-10-20,186,162,24,14.81
1947,1947-10-21,167,164,3,1.83
1947,1947-10-22,216,184,32,17.39
1947,1947-10-23,323,232,91,39.22
1947,1947-10-24,263,254,9,3.54
1947,1947-10-25,309,273,36,13.19
1947,1947-10-26,293,257,36,14.01
1947,1947-10-27,230,221,9,4.07
1947,1947-10-28,223,196,27,13.78
1947,1947-10-30,121,135,-14,-10.37
1947,1947-10-31,138,128,10,7.81
1947,1947-11-01,120,120,0,0
1947,1947-11-02,87,103,-16,-15.53
1947,1947-11-03,83,90,-7,-7.78
1947,1947-11-04,92,91,1,1.1
1947,1947-11-05,73,81,-8,-9.88
1947,1947-11-06,90,91,-1,-1.1
1947,1947-11-07,95,95,0,0
1947,1947-11-08,89,87,2,2.3
1947,1947-11-09,76,80,-4,-5
1947,1947-11-10,64,66,-2,-3.03
1947,1947-11-11,80,80,0,0
1947,1947-11-12,112,115,-3,-2.61
1947,1947-11-13,193,153,40,26.14
1947,1947-11-14,203,170,33,19.41
1947,1947-11-16,204,210,-6,-2.86
1947,1947-11-17,182,169,13,7.69
1947,1947-11-18,225,208,17,8.17
1947,1947-11-19,249,229,20,8.73
1947,1947-11-20,215,238,-23,-9.66
1947,1947-11-21,249,237,12,5.06
1947,1947-11-22,251,213,38,17.84
1947,1947-11-23,228,208,20,9.62
1947,1947-11-24,261,247,14,5.67
1947,1947-11-25,265,240,25,10.42
1947,1947-11-26,199,214,-15,-7.01
1947,1947-11-27,169,168,1,0.6
1947,1947-11-28,155,155,0,0
1947,1947-11-29,158,146,12,8.22
1947,1947-11-30,141,138,3,2.17
1947,1947-12-01,187,148,39,26.35
1947,1947-12-02,130,125,5,4
1947,1947-12-06,153,147,6,4.08
1947,1947-12-07,163,156,7,4.49
1947,1947-12-08,154,139,15,10.79
1947,1947-12-10,140,140,0,0
1947,1947-12-11,185,147,38,25.85
1947,1947-12-12,169,170,-1,-0.59
1947,1947-12-13,200,181,19,10.5
1947,1947-12-14,191,172,19,11.05
1947,1947-12-16,161,156,5,3.21
1947,1947-12-17,174,176,-2,-1.14
1947,1947-12-18,183,166,17,10.24
1947,1947-12-19,144,160,-16,-10
1947,1947-12-20,165,177,-12,-6.78
1947,1947-12-21,132,138,-6,-4.35
1947,1947-12-22,143,141,2,1.42
1947,1947-12-23,135,118,17,14.41
1947,1947-12-24,132,133,-1,-0.75
1947,1947-12-25,130,143,-13,-9.09
1947,1947-12-27,184,186,-2,-1.08
1947,1947-12-30,120,140,-20,-14.29
1947,1947-12-31,151,148,3,2.03
1948,1948-01-01,190,170,20,11.76
1948,1948-01-02,197,181,16,8.84
1948,1948-01-03,186,183,3,1.64
1948,1948-01-05,134,136,-2,-1.47
1948,1948-01-06,111,124,-13,-10.48
1948,1948-01-07,161,150,11,7.33
1948,1948-01-08,150,141,9,6.38
1948,1948-01-09,156,162,-6,-3.7
1948,1948-01-10,113,130,-17,-13.08
1948,1948-01-11,108,101,7,6.93
1948,1948-01-12,113,111,2,1.8
1948,1948-01-13,121,120,1,0.83
1948,1948-01-14,117,119,-2,-1.68
1948,1948-01-15,117,130,-13,-10
1948,1948-01-16,129,136,-7,-5.15
1948,1948-01-17,114,131,-17,-12.98
1948,1948-01-18,116,112,4,3.57
1948,1948-01-19,92,100,-8,-8
1948,1948-01-20,101,106,-5,-4.72
1948,1948-01-21,137,132,5,3.79
1948,1948-01-22,145,145,0,0
1948,1948-01-23,160,134,26,19.4
1948,1948-01-24,128,118,10,8.47
1948,1948-01-25,146,135,11,8.15
1948,1948-01-26,145,152,-7,-4.61
1948,1948-01-27,147,128,19,14.84
1948,1948-01-28,141,121,20,16.53
1948,1948-01-29,115,112,3,2.68
1948,1948-01-30,110,101,9,8.91
1948,1948-01-31,73,69,4,5.8
1948,1948-02-01,80,78,2,2.56
1948,1948-02-02,94,96,-2,-2.08
1948,1948-02-03,101,90,11,12.22
1948,1948-02-04,103,107,-4,-3.74
1948,1948-02-05,131,116,15,12.93
1948,1948-02-06,136,143,-7,-4.9
1948,1948-02-07,167,145,22,15.17
1948,1948-02-08,116,137,-21,-15.33
1948,1948-02-09,129,118,11,9.32
1948,1948-02-10,112,126,-14,-11.11
1948,1948-02-11,102,101,1,0.99
1948,1948-02-12,80,78,2,2.56
1948,1948-02-14,41,47,-6,-12.77
1948,1948-02-15,113,75,38,50.67
1948,1948-02-17,114,115,-1,-0.87
1948,1948-02-18,140,132,8,6.06
1948,1948-02-19,125,131,-6,-4.58
1948,1948-02-20,150,153,-3,-1.96
1948,1948-02-21,130,140,-10,-7.14
1948,1948-02-22,109,124,-15,-12.1
1948,1948-02-23,92,109,-17,-15.6
1948,1948-02-24,77,83,-6,-7.23
1948,1948-02-25,96,105,-9,-8.57
1948,1948-02-27,91,75,16,21.33
1948,1948-02-28,126,128,-2,-1.56
1948,1948-02-29,108,120,-12,-10
1948,1948-03-01,126,127,-1,-0.79
1948,1948-03-02,103,133,-30,-22.56
1948,1948-03-03,117,119,-2,-1.68
1948,1948-03-04,96,111,-15,-13.51
1948,1948-03-05,124,102,22,21.57
1948,1948-03-06,114,105,9,8.57
1948,1948-03-07,52,90,-38,-42.22
1948,1948-03-08,80,88,-8,-9.09
1948,1948-03-09,91,92,-1,-1.09
1948,1948-03-10,135,105,30,28.57
1948,1948-03-11,120,125,-5,-4
1948,1948-03-12,123,119,4,3.36
1948,1948-03-13,118,121,-3,-2.48
1948,1948-03-14,166,125,41,32.8
1948,1948-03-15,146,141,5,3.55
1948,1948-03-16,98,99,-1,-1.01
1948,1948-03-17,123,112,11,9.82
1948,1948-03-18,110,98,12,12.24
1948,1948-03-20,80,63,17,26.98
1948,1948-03-21,29,31,-2,-6.45
1948,1948-03-22,11,9,2,22.22
1948,1948-03-23,11,47,-36,-76.6
1948,1948-03-24,46,59,-13,-22.03
1948,1948-03-25,85,68,17,25
1948,1948-03-26,94,83,11,13.25
1948,1948-03-27,133,115,18,15.65
1948,1948-03-29,154,161,-7,-4.35
1948,1948-03-30,192,195,-3,-1.54
1948,1948-03-31,192,178,14,7.87
1948,1948-04-01,204,201,3,1.49
1948,1948-04-03,227,227,0,0
1948,1948-04-04,231,220,11,5
1948,1948-04-05,248,227,21,9.25
1948,1948-04-06,207,199,8,4.02
1948,1948-04-07,226,205,21,10.24
1948,1948-04-08,159,194,-35,-18.04
1948,1948-04-09,236,211,25,11.85
1948,1948-04-10,223,199,24,12.06
1948,1948-04-11,242,223,19,8.52
1948,1948-04-12,272,261,11,4.21
1948,1948-04-13,242,264,-22,-8.33
1948,1948-04-14,287,295,-8,-2.71
1948,1948-04-16,306,266,40,15.04
1948,1948-04-17,321,263,58,22.05
1948,1948-04-18,267,237,30,12.66
1948,1948-04-19,226,228,-2,-0.88
1948,1948-04-20,184,215,-31,-14.42
1948,1948-04-21,210,209,1,0.48
1948,1948-04-22,229,226,3,1.33
1948,1948-04-23,251,243,8,3.29
1948,1948-04-25,240,244,-4,-1.64
1948,1948-04-26,234,211,23,10.9
1948,1948-04-27,195,204,-9,-4.41
1948,1948-04-28,149,170,-21,-12.35
1948,1948-04-29,154,154,0,0
1948,1948-04-30,115,143,-28,-19.58
1948,1948-05-01,130,147,-17,-11.56
1948,1948-05-02,122,138,-16,-11.59
1948,1948-05-03,160,155,5,3.23
1948,1948-05-04,201,170,31,18.24
1948,1948-05-05,268,232,36,15.52
1948,1948-05-06,239,251,-12,-4.78
1948,1948-05-08,285,264,21,7.95
1948,1948-05-09,341,311,30,9.65
1948,1948-05-10,304,320,-16,-5
1948,1948-05-11,343,354,-11,-3.11
1948,1948-05-12,310,337,-27,-8.01
1948,1948-05-13,287,279,8,2.87
1948,1948-05-14,324,263,61,23.19
1948,1948-05-15,228,216,12,5.56
1948,1948-05-16,242,200,42,21
1948,1948-05-17,129,149,-20,-13.42
1948,1948-05-18,131,141,-10,-7.09
1948,1948-05-19,131,133,-2,-1.5
1948,1948-05-20,108,114,-6,-5.26
1948,1948-05-21,160,121,39,32.23
1948,1948-05-22,133,135,-2,-1.48
1948,1948-05-23,144,127,17,13.39
1948,1948-05-24,135,127,8,6.3
1948,1948-05-25,115,138,-23,-16.67
1948,1948-05-26,149,133,16,12.03
1948,1948-05-27,192,165,27,16.36
1948,1948-05-28,187,180,7,3.89
1948,1948-05-29,152,173,-21,-12.14
1948,1948-06-02,148,156,-8,-5.13
1948,1948-06-03,114,153,-39,-25.49
1948,1948-06-04,165,180,-15,-8.33
1948,1948-06-05,207,213,-6,-2.82
1948,1948-06-06,209,211,-2,-0.95
1948,1948-06-07,147,189,-42,-22.22
1948,1948-06-08,173,181,-8,-4.42
1948,1948-06-09,163,191,-28,-14.66
1948,1948-06-10,163,184,-21,-11.41
1948,1948-06-11,183,187,-4,-2.14
1948,1948-06-12,132,172,-40,-23.26
1948,1948-06-13,169,175,-6,-3.43
1948,1948-06-14,156,182,-26,-14.29
1948,1948-06-15,168,188,-20,-10.64
1948,1948-06-16,226,211,15,7.11
1948,1948-06-17,234,234,0,0
1948,1948-06-18,218,219,-1,-0.46
1948,1948-06-19,200,207,-7,-3.38
1948,1948-06-20,169,171,-2,-1.17
1948,1948-06-21,204,186,18,9.68
1948,1948-06-23,232,233,-1,-0.43
1948,1948-06-24,170,254,-84,-33.07
1948,1948-06-25,313,277,36,13
1948,1948-06-26,245,268,-23,-8.58
1948,1948-06-27,146,247,-101,-40.89
1948,1948-06-28,234,257,-23,-8.95
1948,1948-06-29,302,248,54,21.77
1948,1948-06-30,242,193,49,25.39
1948,1948-07-02,142,149,-7,-4.7
1948,1948-07-03,202,158,44,27.85
1948,1948-07-04,150,154,-4,-2.6
1948,1948-07-05,165,151,14,9.27
1948,1948-07-06,136,132,4,3.03
1948,1948-07-07,132,135,-3,-2.22
1948,1948-07-08,128,138,-10,-7.25
1948,1948-07-09,156,156,0,0
1948,1948-07-10,156,191,-35,-18.32
1948,1948-07-11,199,213,-14,-6.57
1948,1948-07-12,212,218,-6,-2.75
1948,1948-07-13,190,234,-44,-18.8
1948,1948-07-14,189,211,-22,-10.43
1948,1948-07-15,191,191,0,0
1948,1948-07-16,188,183,5,2.73
1948,1948-07-17,108,151,-43,-28.48
1948,1948-07-18,166,163,3,1.84
1948,1948-07-19,142,143,-1,-0.7
1948,1948-07-20,139,150,-11,-7.33
1948,1948-07-21,163,166,-3,-1.81
1948,1948-07-22,124,171,-47,-27.49
1948,1948-07-23,146,173,-27,-15.61
1948,1948-07-24,211,207,4,1.93
1948,1948-07-25,226,221,5,2.26
1948,1948-07-26,244,219,25,11.42
1948,1948-07-27,226,196,30,15.31
1948,1948-07-28,248,217,31,14.29
1948,1948-07-29,232,236,-4,-1.69
1948,1948-07-30,269,259,10,3.86
1948,1948-07-31,299,256,43,16.8
1948,1948-08-01,256,248,8,3.23
1948,1948-08-02,306,243,63,25.93
1948,1948-08-03,301,274,27,9.85
1948,1948-08-04,301,263,38,14.45
1948,1948-08-05,236,249,-13,-5.22
1948,1948-08-06,217,231,-14,-6.06
1948,1948-08-07,213,210,3,1.43
1948,1948-08-08,167,175,-8,-4.57
1948,1948-08-09,150,150,0,0
1948,1948-08-10,122,135,-13,-9.63
1948,1948-08-11,161,146,15,10.27
1948,1948-08-12,154,145,9,6.21
1948,1948-08-13,156,146,10,6.85
1948,1948-08-14,190,162,28,17.28
1948,1948-08-15,228,210,18,8.57
1948,1948-08-16,275,251,24,9.56
1948,1948-08-17,269,264,5,1.89
1948,1948-08-18,312,266,46,17.29
1948,1948-08-19,312,272,40,14.71
1948,1948-08-20,299,289,10,3.46
1948,1948-08-21,276,260,16,6.15
1948,1948-08-22,237,223,14,6.28
1948,1948-08-23,211,178,33,18.54
1948,1948-08-24,230,179,51,28.49
1948,1948-08-25,204,197,7,3.55
1948,1948-08-26,162,175,-13,-7.43
1948,1948-08-27,164,174,-10,-5.75
1948,1948-08-28,162,167,-5,-2.99
1948,1948-08-29,147,142,5,3.52
1948,1948-08-30,169,160,9,5.62
1948,1948-08-31,220,170,50,29.41
1948,1948-09-01,152,148,4,2.7
1948,1948-09-02,179,169,10,5.92
1948,1948-09-03,185,152,33,21.71
1948,1948-09-04,196,153,43,28.1
1948,1948-09-05,143,123,20,16.26
1948,1948-09-06,97,89,8,8.99
1948,1948-09-07,57,65,-8,-12.31
1948,1948-09-08,72,72,0,0
1948,1948-09-09,78,82,-4,-4.88
1948,1948-09-10,109,92,17,18.48
1948,1948-09-11,128,127,1,0.79
1948,1948-09-12,196,160,36,22.5
1948,1948-09-13,223,194,29,14.95
1948,1948-09-14,217,189,28,14.81
1948,1948-09-15,227,190,37,19.47
1948,1948-09-16,235,209,26,12.44
1948,1948-09-17,278,242,36,14.88
1948,1948-09-18,304,250,54,21.6
1948,1948-09-19,307,265,42,15.85
1948,1948-09-20,231,250,-19,-7.6
1948,1948-09-21,254,243,11,4.53
1948,1948-09-22,293,258,35,13.57
1948,1948-09-23,261,267,-6,-2.25
1948,1948-09-24,258,255,3,1.18
1948,1948-09-25,165,186,-21,-11.29
1948,1948-09-26,198,183,15,8.2
1948,1948-09-27,181,177,4,2.26
1948,1948-09-28,170,153,17,11.11
1948,1948-09-29,166,155,11,7.1
1948,1948-09-30,166,139,27,19.42
1948,1948-10-01,158,155,3,1.94
1948,1948-10-02,161,144,17,11.81
1948,1948-10-03,132,122,10,8.2
1948,1948-10-04,133,139,-6,-4.32
1948,1948-10-06,105,95,10,10.53
1948,1948-10-07,88,77,11,14.29
1948,1948-10-08,117,95,22,23.16
1948,1948-10-09,109,102,7,6.86
1948,1948-10-10,183,149,34,22.82
1948,1948-10-11,172,192,-20,-10.42
1948,1948-10-12,269,222,47,21.17
1948,1948-10-13,295,273,22,8.06
1948,1948-10-14,289,288,1,0.35
1948,1948-10-15,243,240,3,1.25
1948,1948-10-16,256,213,43,20.19
1948,1948-10-17,282,208,74,35.58
1948,1948-10-19,180,181,-1,-0.55
1948,1948-10-20,213,208,5,2.4
1948,1948-10-21,194,241,-47,-19.5
1948,1948-10-22,199,213,-14,-6.57
1948,1948-10-23,173,201,-28,-13.93
1948,1948-10-24,154,167,-13,-7.78
1948,1948-10-25,169,144,25,17.36
1948,1948-10-26,116,143,-27,-18.88
1948,1948-10-27,130,140,-10,-7.14
1948,1948-10-28,138,133,5,3.76
1948,1948-10-29,145,149,-4,-2.68
1948,1948-10-30,96,114,-18,-15.79
1948,1948-10-31,126,108,18,16.67
1948,1948-11-01,127,106,21,19.81
1948,1948-11-02,136,106,30,28.3
1948,1948-11-04,101,110,-9,-8.18
1948,1948-11-05,188,135,53,39.26
1948,1948-11-06,113,112,1,0.89
1948,1948-11-07,136,126,10,7.94
1948,1948-11-08,145,120,25,20.83
1948,1948-11-09,189,134,55,41.04
1948,1948-11-10,143,123,20,16.26
1948,1948-11-11,171,137,34,24.82
1948,1948-11-12,192,159,33,20.75
1948,1948-11-13,148,150,-2,-1.33
1948,1948-11-14,169,129,40,31.01
1948,1948-11-15,172,126,46,36.51
1948,1948-11-16,213,140,73,52.14
1948,1948-11-17,204,147,57,38.78
1948,1948-11-18,453,196,257,131.12
1948,1948-11-19,334,215,119,55.35
1948,1948-11-20,238,183,55,30.05
1948,1948-11-21,175,162,13,8.02
1948,1948-11-22,239,159,80,50.31
1948,1948-11-23,164,115,49,42.61
1948,1948-11-24,193,107,86,80.37
1948,1948-11-25,153,134,19,14.18
1948,1948-11-26,105,102,3,2.94
1948,1948-11-27,110,92,18,19.57
1948,1948-11-28,103,82,21,25.61
1948,1948-11-29,109,75,34,45.33
1948,1948-11-30,95,74,21,28.38
1948,1948-12-01,124,86,38,44.19
1948,1948-12-02,71,81,-10,-12.35
1948,1948-12-03,111,103,8,7.77
1948,1948-12-05,99,92,7,7.61
1948,1948-12-07,214,148,66,44.59
1948,1948-12-08,181,144,37,25.69
1948,1948-12-09,176,142,34,23.94
1948,1948-12-10,216,121,95,78.51
1948,1948-12-11,115,116,-1,-0.86
1948,1948-12-12,233,162,71,43.83
1948,1948-12-14,146,169,-23,-13.61
1948,1948-12-15,335,230,105,45.65
1948,1948-12-18,329,286,43,15.03
1948,1948-12-19,381,289,92,31.83
1948,1948-12-20,369,280,89,31.79
1948,1948-12-23,308,218,90,41.28
1948,1948-12-24,287,220,67,30.45
1948,1948-12-25,338,215,123,57.21
1948,1948-12-26,233,193,40,20.73
1948,1948-12-27,254,191,63,32.98
1948,1948-12-28,276,189,87,46.03
1948,1948-12-29,267,203,64,31.53
1949,1949-01-01,141,128,13,10.16
1949,1949-01-02,128,144,-16,-11.11
1949,1949-01-03,105,112,-7,-6.25
1949,1949-01-04,154,111,43,38.74
1949,1949-01-05,146,103,43,41.75
1949,1949-01-06,142,105,37,35.24
1949,1949-01-07,211,124,87,70.16
1949,1949-01-08,136,135,1,0.74
1949,1949-01-09,157,145,12,8.28
1949,1949-01-10,180,155,25,16.13
1949,1949-01-12,205,130,75,57.69
1949,1949-01-13,206,166,40,24.1
1949,1949-01-14,286,165,121,73.33
1949,1949-01-15,169,158,11,6.96
1949,1949-01-16,203,183,20,10.93
1949,1949-01-17,321,212,109,51.42
1949,1949-01-18,298,217,81,37.33
1949,1949-01-22,181,182,-1,-0.55
1949,1949-01-23,212,179,33,18.44
1949,1949-01-24,268,182,86,47.25
1949,1949-01-25,192,169,23,13.61
1949,1949-01-26,179,139,40,28.78
1949,1949-01-27,160,117,43,36.75
1949,1949-01-28,99,109,-10,-9.17
1949,1949-01-29,107,95,12,12.63
1949,1949-01-30,148,127,21,16.54
1949,1949-01-31,236,185,51,27.57
1949,1949-02-01,255,198,57,28.79
1949,1949-02-02,320,232,88,37.93
1949,1949-02-03,320,229,91,39.74
1949,1949-02-04,368,244,124,50.82
1949,1949-02-05,300,287,13,4.53
1949,1949-02-06,319,279,40,14.34
1949,1949-02-07,334,275,59,21.45
1949,1949-02-08,369,274,95,34.67
1949,1949-02-09,343,255,88,34.51
1949,1949-02-10,285,243,42,17.28
1949,1949-02-12,222,238,-16,-6.72
1949,1949-02-13,216,243,-27,-11.11
1949,1949-02-14,340,281,59,21
1949,1949-02-15,368,297,71,23.91
1949,1949-02-16,298,259,39,15.06
1949,1949-02-17,294,253,41,16.21
1949,1949-02-18,271,256,15,5.86
1949,1949-02-19,274,264,10,3.79
1949,1949-02-20,230,223,7,3.14
1949,1949-02-21,201,187,14,7.49
1949,1949-02-22,187,171,16,9.36
1949,1949-02-24,117,148,-31,-20.95
1949,1949-02-26,118,150,-32,-21.33
1949,1949-02-27,155,157,-2,-1.27
1949,1949-02-28,235,194,41,21.13
1949,1949-03-01,245,190,55,28.95
1949,1949-03-02,147,187,-40,-21.39
1949,1949-03-03,178,202,-24,-11.88
1949,1949-03-04,205,199,6,3.02
1949,1949-03-05,270,219,51,23.29
1949,1949-03-06,178,203,-25,-12.32
1949,1949-03-07,201,192,9,4.69
1949,1949-03-08,203,216,-13,-6.02
1949,1949-03-09,248,230,18,7.83
1949,1949-03-11,214,202,12,5.94
1949,1949-03-12,199,199,0,0
1949,1949-03-13,198,214,-16,-7.48
1949,1949-03-14,245,242,3,1.24
1949,1949-03-15,252,224,28,12.5
1949,1949-03-16,215,226,-11,-4.87
1949,1949-03-17,234,248,-14,-5.65
1949,1949-03-18,258,228,30,13.16
1949,1949-03-19,230,239,-9,-3.77
1949,1949-03-20,292,251,41,16.33
1949,1949-03-21,265,257,8,3.11
1949,1949-03-22,202,213,-11,-5.16
1949,1949-03-23,192,189,3,1.59
1949,1949-03-25,169,151,18,11.92
1949,1949-03-26,149,150,-1,-0.67
1949,1949-03-27,132,132,0,0
1949,1949-03-28,121,124,-3,-2.42
1949,1949-03-29,123,133,-10,-7.52
1949,1949-03-30,167,150,17,11.33
1949,1949-03-31,92,179,-87,-48.6
1949,1949-04-02,174,201,-27,-13.43
1949,1949-04-03,227,210,17,8.1
1949,1949-04-04,269,240,29,12.08
1949,1949-04-05,244,217,27,12.44
1949,1949-04-07,245,201,44,21.89
1949,1949-04-08,217,199,18,9.05
1949,1949-04-09,198,170,28,16.47
1949,1949-04-10,161,164,-3,-1.83
1949,1949-04-11,191,163,28,17.18
1949,1949-04-12,173,184,-11,-5.98
1949,1949-04-13,176,174,2,1.15
1949,1949-04-15,173,181,-8,-4.42
1949,1949-04-16,241,169,72,42.6
1949,1949-04-17,232,189,43,22.75
1949,1949-04-19,207,181,26,14.36
1949,1949-04-20,217,199,18,9.05
1949,1949-04-21,246,221,25,11.31
1949,1949-04-23,163,206,-43,-20.87
1949,1949-04-25,222,215,7,3.26
1949,1949-04-26,166,186,-20,-10.75
1949,1949-04-27,186,198,-12,-6.06
1949,1949-04-28,178,169,9,5.33
1949,1949-04-29,157,156,1,0.64
1949,1949-04-30,129,136,-7,-5.15
1949,1949-05-01,114,156,-42,-26.92
1949,1949-05-03,149,164,-15,-9.15
1949,1949-05-04,165,181,-16,-8.84
1949,1949-05-05,180,207,-27,-13.04
1949,1949-05-06,188,200,-12,-6
1949,1949-05-07,138,161,-23,-14.29
1949,1949-05-08,131,164,-33,-20.12
1949,1949-05-09,133,141,-8,-5.67
1949,1949-05-10,101,127,-26,-20.47
1949,1949-05-11,81,108,-27,-25
1949,1949-05-12,82,109,-27,-24.77
1949,1949-05-13,65,85,-20,-23.53
1949,1949-05-14,65,85,-20,-23.53
1949,1949-05-15,77,90,-13,-14.44
1949,1949-05-16,101,112,-11,-9.82
1949,1949-05-17,152,153,-1,-0.65
1949,1949-05-18,141,136,5,3.68
1949,1949-05-20,149,138,11,7.97
1949,1949-05-21,155,152,3,1.97
1949,1949-05-22,163,151,12,7.95
1949,1949-05-23,179,166,13,7.83
1949,1949-05-24,200,189,11,5.82
1949,1949-05-25,136,152,-16,-10.53
1949,1949-05-29,150,167,-17,-10.18
1949,1949-05-30,182,168,14,8.33
1949,1949-05-31,159,165,-6,-3.64
1949,1949-06-01,162,177,-15,-8.47
1949,1949-06-02,148,178,-30,-16.85
1949,1949-06-03,143,165,-22,-13.33
1949,1949-06-04,133,175,-42,-24
1949,1949-06-05,102,160,-58,-36.25
1949,1949-06-06,180,145,35,24.14
1949,1949-06-07,99,112,-13,-11.61
1949,1949-06-08,106,115,-9,-7.83
1949,1949-06-09,95,98,-3,-3.06
1949,1949-06-10,94,89,5,5.62
1949,1949-06-11,84,104,-20,-19.23
1949,1949-06-12,105,120,-15,-12.5
1949,1949-06-13,98,143,-45,-31.47
1949,1949-06-14,64,97,-33,-34.02
1949,1949-06-15,96,102,-6,-5.88
1949,1949-06-16,128,123,5,4.07
1949,1949-06-17,79,97,-18,-18.56
1949,1949-06-18,96,115,-19,-16.52
1949,1949-06-19,105,114,-9,-7.89
1949,1949-06-20,113,117,-4,-3.42
1949,1949-06-21,130,128,2,1.56
1949,1949-06-22,164,137,27,19.71
1949,1949-06-23,172,166,6,3.61
1949,1949-06-24,181,175,6,3.43
1949,1949-06-25,197,169,28,16.57
1949,1949-06-26,196,238,-42,-17.65
1949,1949-06-27,287,255,32,12.55
1949,1949-06-29,325,264,61,23.11
1949,1949-06-30,319,260,59,22.69
1949,1949-07-01,212,200,12,6
1949,1949-07-02,181,172,9,5.23
1949,1949-07-03,148,142,6,4.23
1949,1949-07-04,96,98,-2,-2.04
1949,1949-07-05,99,82,17,20.73
1949,1949-07-06,93,114,-21,-18.42
1949,1949-07-07,105,108,-3,-2.78
1949,1949-07-08,69,88,-19,-21.59
1949,1949-07-09,61,72,-11,-15.28
1949,1949-07-10,77,68,9,13.24
1949,1949-07-11,79,87,-8,-9.2
1949,1949-07-12,118,129,-11,-8.53
1949,1949-07-13,139,127,12,9.45
1949,1949-07-14,144,131,13,9.92
1949,1949-07-15,154,148,6,4.05
1949,1949-07-16,150,140,10,7.14
1949,1949-07-17,131,127,4,3.15
1949,1949-07-18,171,159,12,7.55
1949,1949-07-19,201,183,18,9.84
1949,1949-07-20,198,196,2,1.02
1949,1949-07-21,207,181,26,14.36
1949,1949-07-22,191,172,19,11.05
1949,1949-07-23,217,194,23,11.86
1949,1949-07-24,192,224,-32,-14.29
1949,1949-07-25,203,207,-4,-1.93
1949,1949-07-26,239,205,34,16.59
1949,1949-07-27,217,201,16,7.96
1949,1949-07-28,211,202,9,4.46
1949,1949-07-29,208,198,10,5.05
1949,1949-07-30,207,214,-7,-3.27
1949,1949-07-31,215,193,22,11.4
1949,1949-08-01,204,174,30,17.24
1949,1949-08-02,218,172,46,26.74
1949,1949-08-03,205,163,42,25.77
1949,1949-08-04,166,132,34,25.76
1949,1949-08-05,128,125,3,2.4
1949,1949-08-06,65,78,-13,-16.67
1949,1949-08-07,40,55,-15,-27.27
1949,1949-08-08,44,52,-8,-15.38
1949,1949-08-09,39,56,-17,-30.36
1949,1949-08-10,35,37,-2,-5.41
1949,1949-08-11,12,22,-10,-45.45
1949,1949-08-12,82,66,16,24.24
1949,1949-08-13,159,128,31,24.22
1949,1949-08-14,153,163,-10,-6.13
1949,1949-08-15,219,188,31,16.49
1949,1949-08-16,201,195,6,3.08
1949,1949-08-17,271,228,43,18.86
1949,1949-08-18,225,235,-10,-4.26
1949,1949-08-19,251,220,31,14.09
1949,1949-08-20,232,224,8,3.57
1949,1949-08-21,206,236,-30,-12.71
1949,1949-08-22,232,242,-10,-4.13
1949,1949-08-23,234,230,4,1.74
1949,1949-08-24,216,217,-1,-0.46
1949,1949-08-25,212,206,6,2.91
1949,1949-08-26,205,200,5,2.5
1949,1949-08-27,238,197,41,20.81
1949,1949-08-28,236,210,26,12.38
1949,1949-08-29,195,210,-15,-7.14
1949,1949-08-30,158,197,-39,-19.8
1949,1949-08-31,203,218,-15,-6.88
1949,1949-09-01,221,234,-13,-5.56
1949,1949-09-02,238,225,13,5.78
1949,1949-09-03,207,224,-17,-7.59
1949,1949-09-04,240,229,11,4.8
1949,1949-09-05,218,223,-5,-2.24
1949,1949-09-06,248,222,26,11.71
1949,1949-09-07,261,212,49,23.11
1949,1949-09-09,213,196,17,8.67
1949,1949-09-10,213,220,-7,-3.18
1949,1949-09-11,243,235,8,3.4
1949,1949-09-12,223,213,10,4.69
1949,1949-09-13,209,200,9,4.5
1949,1949-09-14,191,183,8,4.37
1949,1949-09-15,196,179,17,9.5
1949,1949-09-16,189,166,23,13.86
1949,1949-09-17,199,216,-17,-7.87
1949,1949-09-18,226,226,0,0
1949,1949-09-19,212,223,-11,-4.93
1949,1949-09-20,216,221,-5,-2.26
1949,1949-09-21,169,187,-18,-9.63
1949,1949-09-22,173,199,-26,-13.07
1949,1949-09-23,219,175,44,25.14
1949,1949-09-24,155,167,-12,-7.19
1949,1949-09-25,126,63,63,100
1949,1949-09-26,139,138,1,0.72
1949,1949-09-27,79,101,-22,-21.78
1949,1949-09-28,78,92,-14,-15.22
1949,1949-09-29,52,66,-14,-21.21
1949,1949-09-30,72,65,7,10.77
1949,1949-10-01,96,112,-16,-14.29
1949,1949-10-02,134,151,-17,-11.26
1949,1949-10-03,195,213,-18,-8.45
1949,1949-10-04,260,228,32,14.04
1949,1949-10-06,247,260,-13,-5
1949,1949-10-08,389,289,100,34.6
1949,1949-10-09,286,267,19,7.12
1949,1949-10-10,234,226,8,3.54
1949,1949-10-11,274,265,9,3.4
1949,1949-10-12,236,237,-1,-0.42
1949,1949-10-13,157,204,-47,-23.04
1949,1949-10-14,163,186,-23,-12.37
1949,1949-10-15,158,207,-49,-23.67
1949,1949-10-16,145,179,-34,-18.99
1949,1949-10-18,62,93,-31,-33.33
1949,1949-10-19,59,69,-10,-14.49
1949,1949-10-20,90,87,3,3.45
1949,1949-10-21,133,121,12,9.92
1949,1949-10-22,189,170,19,11.18
1949,1949-10-23,130,147,-17,-11.56
1949,1949-10-24,164,130,34,26.15
1949,1949-10-25,126,121,5,4.13
1949,1949-10-26,118,96,22,22.92
1949,1949-10-27,122,122,0,0
1949,1949-10-28,112,121,-9,-7.44
1949,1949-10-29,123,121,2,1.65
1949,1949-10-30,143,140,3,2.14
1949,1949-10-31,151,132,19,14.39
1949,1949-11-01,122,137,-15,-10.95
1949,1949-11-02,136,136,0,0
1949,1949-11-03,197,153,44,28.76
1949,1949-11-04,211,166,45,27.11
1949,1949-11-05,233,179,54,30.17
1949,1949-11-06,199,193,6,3.11
1949,1949-11-07,237,205,32,15.61
1949,1949-11-08,165,215,-50,-23.26
1949,1949-11-09,209,235,-26,-11.06
1949,1949-11-10,227,192,35,18.23
1949,1949-11-11,179,201,-22,-10.95
1949,1949-11-12,231,202,29,14.36
1949,1949-11-13,256,194,62,31.96
1949,1949-11-14,291,173,118,68.21
1949,1949-11-15,142,180,-38,-21.11
1949,1949-11-16,217,190,27,14.21
1949,1949-11-17,269,204,65,31.86
1949,1949-11-18,268,216,52,24.07
1949,1949-11-19,259,214,45,21.03
1949,1949-11-20,216,191,25,13.09
1949,1949-11-21,242,184,58,31.52
1949,1949-11-22,114,161,-47,-29.19
1949,1949-11-23,171,173,-2,-1.16
1949,1949-11-24,206,226,-20,-8.85
1949,1949-11-25,200,211,-11,-5.21
1949,1949-11-26,126,148,-22,-14.86
1949,1949-11-30,178,206,-28,-13.59
1949,1949-12-01,164,187,-23,-12.3
1949,1949-12-02,138,166,-28,-16.87
1949,1949-12-03,122,143,-21,-14.69
1949,1949-12-04,137,137,0,0
1949,1949-12-05,117,129,-12,-9.3
1949,1949-12-08,139,174,-35,-20.11
1949,1949-12-09,161,174,-13,-7.47
1949,1949-12-10,141,164,-23,-14.02
1949,1949-12-11,161,175,-14,-8
1949,1949-12-12,243,195,48,24.62
1949,1949-12-13,165,189,-24,-12.7
1949,1949-12-14,221,148,73,49.32
1949,1949-12-15,95,129,-34,-26.36
1949,1949-12-16,99,129,-30,-23.26
1949,1949-12-17,109,125,-16,-12.8
1949,1949-12-20,106,118,-12,-10.17
1949,1949-12-21,117,119,-2,-1.68
1949,1949-12-22,168,167,1,0.6
1949,1949-12-23,183,162,21,12.96
1949,1949-12-24,143,161,-18,-11.18
1949,1949-12-25,158,170,-12,-7.06
1949,1949-12-27,185,150,35,23.33
1949,1949-12-28,124,163,-39,-23.93
1949,1949-12-29,143,138,5,3.62
1949,1949-12-30,114,116,-2,-1.72
1949,1949-12-31,149,122,27,22.13
1950,1950-01-02,81,109,-28,-25.69
1950,1950-01-03,100,99,1,1.01
1950,1950-01-04,82,98,-16,-16.33
1950,1950-01-05,93,95,-2,-2.11
1950,1950-01-06,105,99,6,6.06
1950,1950-01-07,71,86,-15,-17.44
1950,1950-01-08,42,74,-32,-43.24
1950,1950-01-09,92,86,6,6.98
1950,1950-01-10,70,88,-18,-20.45
1950,1950-01-13,99,89,10,11.24
1950,1950-01-15,90,96,-6,-6.25
1950,1950-01-16,103,92,11,11.96
1950,1950-01-17,131,110,21,19.09
1950,1950-01-19,253,177,76,42.94
1950,1950-01-20,198,182,16,8.79
1950,1950-01-21,183,183,0,0
1950,1950-01-22,215,202,13,6.44
1950,1950-01-23,189,193,-4,-2.07
1950,1950-01-24,227,216,11,5.09
1950,1950-01-25,210,223,-13,-5.83
1950,1950-01-26,191,189,2,1.06
1950,1950-01-27,154,149,5,3.36
1950,1950-01-29,134,120,14,11.67
1950,1950-01-30,69,108,-39,-36.11
1950,1950-01-31,74,97,-23,-23.71
1950,1950-02-01,44,63,-19,-30.16
1950,1950-02-03,25,32,-7,-21.88
1950,1950-02-04,41,42,-1,-2.38
1950,1950-02-06,31,36,-5,-13.89
1950,1950-02-07,11,36,-25,-69.44
1950,1950-02-11,62,76,-14,-18.42
1950,1950-02-12,79,95,-16,-16.84
1950,1950-02-13,144,120,24,20
1950,1950-02-14,235,195,40,20.51
1950,1950-02-15,236,202,34,16.83
1950,1950-02-16,274,198,76,38.38
1950,1950-02-17,205,219,-14,-6.39
1950,1950-02-19,227,214,13,6.07
1950,1950-02-21,269,225,44,19.56
1950,1950-02-22,237,202,35,17.33
1950,1950-02-23,174,162,12,7.41
1950,1950-02-24,116,145,-29,-20
1950,1950-02-25,81,113,-32,-28.32
1950,1950-02-26,75,94,-19,-20.21
1950,1950-02-27,76,103,-27,-26.21
1950,1950-02-28,82,104,-22,-21.15
1950,1950-03-01,47,102,-55,-53.92
1950,1950-03-02,83,88,-5,-5.68
1950,1950-03-03,129,120,9,7.5
1950,1950-03-04,160,171,-11,-6.43
1950,1950-03-05,174,189,-15,-7.94
1950,1950-03-06,166,182,-16,-8.79
1950,1950-03-07,187,226,-39,-17.26
1950,1950-03-08,187,231,-44,-19.05
1950,1950-03-09,194,192,2,1.04
1950,1950-03-10,148,176,-28,-15.91
1950,1950-03-12,145,165,-20,-12.12
1950,1950-03-14,114,160,-46,-28.75
1950,1950-03-15,138,160,-22,-13.75
1950,1950-03-16,124,139,-15,-10.79
1950,1950-03-17,135,128,7,5.47
1950,1950-03-18,77,105,-28,-26.67
1950,1950-03-19,94,113,-19,-16.81
1950,1950-03-20,93,111,-18,-16.22
1950,1950-03-21,85,95,-10,-10.53
1950,1950-03-22,62,79,-17,-21.52
1950,1950-03-23,54,77,-23,-29.87
1950,1950-03-24,82,88,-6,-6.82
1950,1950-03-25,108,112,-4,-3.57
1950,1950-03-26,74,89,-15,-16.85
1950,1950-03-27,73,92,-19,-20.65
1950,1950-03-28,89,104,-15,-14.42
1950,1950-03-29,147,139,8,5.76
1950,1950-03-30,97,111,-14,-12.61
1950,1950-03-31,75,94,-19,-20.21
1950,1950-04-01,99,92,7,7.61
1950,1950-04-02,126,131,-5,-3.82
1950,1950-04-03,165,174,-9,-5.17
1950,1950-04-04,181,194,-13,-6.7
1950,1950-04-05,189,178,11,6.18
1950,1950-04-06,177,160,17,10.62
1950,1950-04-07,105,145,-40,-27.59
1950,1950-04-08,119,124,-5,-4.03
1950,1950-04-09,111,125,-14,-11.2
1950,1950-04-10,97,105,-8,-7.62
1950,1950-04-11,86,90,-4,-4.44
1950,1950-04-12,137,102,35,34.31
1950,1950-04-13,160,115,45,39.13
1950,1950-04-14,175,138,37,26.81
1950,1950-04-15,115,144,-29,-20.14
1950,1950-04-16,133,145,-12,-8.28
1950,1950-04-17,156,132,24,18.18
1950,1950-04-19,120,101,19,18.81
1950,1950-04-20,102,87,15,17.24
1950,1950-04-21,65,90,-25,-27.78
1950,1950-04-22,60,85,-25,-29.41
1950,1950-04-24,157,157,0,0
1950,1950-04-25,217,178,39,21.91
1950,1950-04-26,145,174,-29,-16.67
1950,1950-04-29,203,198,5,2.53
1950,1950-04-30,235,201,34,16.92
1950,1950-05-02,191,179,12,6.7
1950,1950-05-03,142,158,-16,-10.13
1950,1950-05-04,159,158,1,0.63
1950,1950-05-05,139,139,0,0
1950,1950-05-06,141,143,-2,-1.4
1950,1950-05-07,136,144,-8,-5.56
1950,1950-05-08,138,148,-10,-6.76
1950,1950-05-09,88,104,-16,-15.38
1950,1950-05-10,50,100,-50,-50
1950,1950-05-11,75,101,-26,-25.74
1950,1950-05-13,51,65,-14,-21.54
1950,1950-05-14,51,59,-8,-13.56
1950,1950-05-15,48,56,-8,-14.29
1950,1950-05-16,62,74,-12,-16.22
1950,1950-05-17,69,86,-17,-19.77
1950,1950-05-18,112,113,-1,-0.88
1950,1950-05-19,142,124,18,14.52
1950,1950-05-21,148,146,2,1.37
1950,1950-05-22,157,173,-16,-9.25
1950,1950-05-24,215,194,21,10.82
1950,1950-05-25,199,184,15,8.15
1950,1950-05-26,181,176,5,2.84
1950,1950-05-27,158,162,-4,-2.47
1950,1950-05-28,79,134,-55,-41.04
1950,1950-05-29,76,117,-41,-35.04
1950,1950-05-30,87,94,-7,-7.45
1950,1950-05-31,102,92,10,10.87
1950,1950-06-01,90,112,-22,-19.64
1950,1950-06-02,108,113,-5,-4.42
1950,1950-06-03,87,104,-17,-16.35
1950,1950-06-04,66,84,-18,-21.43
1950,1950-06-05,51,67,-16,-23.88
1950,1950-06-06,52,62,-10,-16.13
1950,1950-06-07,57,63,-6,-9.52
1950,1950-06-08,70,77,-7,-9.09
1950,1950-06-09,116,101,15,14.85
1950,1950-06-10,110,107,3,2.8
1950,1950-06-11,79,97,-18,-18.56
1950,1950-06-12,86,91,-5,-5.49
1950,1950-06-13,136,121,15,12.4
1950,1950-06-14,105,129,-24,-18.6
1950,1950-06-15,100,116,-16,-13.79
1950,1950-06-17,95,98,-3,-3.06
1950,1950-06-18,79,92,-13,-14.13
1950,1950-06-20,52,71,-19,-26.76
1950,1950-06-21,83,86,-3,-3.49
1950,1950-06-22,102,106,-4,-3.77
1950,1950-06-23,151,114,37,32.46
1950,1950-06-24,151,140,11,7.86
1950,1950-06-25,164,153,11,7.19
1950,1950-06-26,131,141,-10,-7.09
1950,1950-06-27,95,100,-5,-5
1950,1950-06-28,86,75,11,14.67
1950,1950-06-29,84,86,-2,-2.33
1950,1950-06-30,78,88,-10,-11.36
1950,1950-07-01,63,80,-17,-21.25
1950,1950-07-02,68,68,0,0
1950,1950-07-03,52,59,-7,-11.86
1950,1950-07-04,50,58,-8,-13.79
1950,1950-07-05,60,63,-3,-4.76
1950,1950-07-07,98,104,-6,-5.77
1950,1950-07-08,75,90,-15,-16.67
1950,1950-07-09,88,86,2,2.33
1950,1950-07-11,72,92,-20,-21.74
1950,1950-07-12,66,81,-15,-18.52
1950,1950-07-18,102,99,3,3.03
1950,1950-07-19,107,111,-4,-3.6
1950,1950-07-21,137,129,8,6.2
1950,1950-07-22,130,139,-9,-6.47
1950,1950-07-23,135,133,2,1.5
1950,1950-07-24,142,136,6,4.41
1950,1950-07-25,101,130,-29,-22.31
1950,1950-07-26,109,150,-41,-27.33
1950,1950-07-27,134,144,-10,-6.94
1950,1950-07-28,131,142,-11,-7.75
1950,1950-07-29,166,134,32,23.88
1950,1950-07-30,142,117,25,21.37
1950,1950-07-31,107,91,16,17.58
1950,1950-08-01,132,104,28,26.92
1950,1950-08-02,170,128,42,32.81
1950,1950-08-03,134,113,21,18.58
1950,1950-08-04,121,104,17,16.35
1950,1950-08-05,101,97,4,4.12
1950,1950-08-06,95,103,-8,-7.77
1950,1950-08-07,95,104,-9,-8.65
1950,1950-08-08,76,90,-14,-15.56
1950,1950-08-09,78,99,-21,-21.21
1950,1950-08-11,88,93,-5,-5.38
1950,1950-08-12,101,121,-20,-16.53
1950,1950-08-13,91,106,-15,-14.15
1950,1950-08-14,83,92,-9,-9.78
1950,1950-08-15,111,100,11,11
1950,1950-08-17,123,135,-12,-8.89
1950,1950-08-18,147,134,13,9.7
1950,1950-08-19,133,148,-15,-10.14
1950,1950-08-21,105,119,-14,-11.76
1950,1950-08-22,133,128,5,3.91
1950,1950-08-23,136,142,-6,-4.23
1950,1950-08-25,87,117,-30,-25.64
1950,1950-08-26,93,91,2,2.2
1950,1950-08-27,58,66,-8,-12.12
1950,1950-08-28,52,67,-15,-22.39
1950,1950-08-29,83,85,-2,-2.35
1950,1950-08-30,65,72,-7,-9.72
1950,1950-08-31,72,81,-9,-11.11
1950,1950-09-01,72,81,-9,-11.11
1950,1950-09-02,55,63,-8,-12.7
1950,1950-09-03,43,77,-34,-44.16
1950,1950-09-04,37,46,-9,-19.57
1950,1950-09-05,13,22,-9,-40.91
1950,1950-09-06,25,28,-3,-10.71
1950,1950-09-07,27,36,-9,-25
1950,1950-09-08,31,37,-6,-16.22
1950,1950-09-09,37,42,-5,-11.9
1950,1950-09-12,67,58,9,15.52
1950,1950-09-13,98,93,5,5.38
1950,1950-09-14,81,97,-16,-16.49
1950,1950-09-15,97,93,4,4.3
1950,1950-09-16,104,102,2,1.96
1950,1950-09-17,89,97,-8,-8.25
1950,1950-09-18,139,123,16,13.01
1950,1950-09-19,103,108,-5,-4.63
1950,1950-09-20,84,87,-3,-3.45
1950,1950-09-21,40,77,-37,-48.05
1950,1950-09-22,52,74,-22,-29.73
1950,1950-09-23,54,57,-3,-5.26
1950,1950-09-24,70,56,14,25
1950,1950-09-25,61,63,-2,-3.17
1950,1950-09-26,54,59,-5,-8.47
1950,1950-09-27,62,53,9,16.98
1950,1950-09-28,37,45,-8,-17.78
1950,1950-09-30,50,54,-4,-7.41
1950,1950-10-01,41,54,-13,-24.07
1950,1950-10-02,46,56,-10,-17.86
1950,1950-10-03,64,64,0,0
1950,1950-10-04,58,73,-15,-20.55
1950,1950-10-05,63,73,-10,-13.7
1950,1950-10-06,47,56,-9,-16.07
1950,1950-10-07,77,76,1,1.32
1950,1950-10-08,120,109,11,10.09
1950,1950-10-09,120,122,-2,-1.64
1950,1950-10-10,107,99,8,8.08
1950,1950-10-11,87,108,-21,-19.44
1950,1950-10-12,91,94,-3,-3.19
1950,1950-10-13,69,94,-25,-26.6
1950,1950-10-14,96,81,15,18.52
1950,1950-10-15,92,104,-12,-11.54
1950,1950-10-16,123,115,8,6.96
1950,1950-10-17,162,115,47,40.87
1950,1950-10-18,111,93,18,19.35
1950,1950-10-19,50,56,-6,-10.71
1950,1950-10-20,50,42,8,19.05
1950,1950-10-21,27,27,0,0
1950,1950-10-22,22,21,1,4.76
1950,1950-10-24,38,43,-5,-11.63
1950,1950-10-25,24,40,-16,-40
1950,1950-10-26,62,61,1,1.64
1950,1950-10-27,59,55,4,7.27
1950,1950-10-28,83,77,6,7.79
1950,1950-10-29,152,132,20,15.15
1950,1950-10-30,126,124,2,1.61
1950,1950-10-31,98,93,5,5.38
1950,1950-11-01,89,91,-2,-2.2
1950,1950-11-02,88,83,5,6.02
1950,1950-11-03,62,62,0,0
1950,1950-11-04,109,104,5,4.81
1950,1950-11-05,112,115,-3,-2.61
1950,1950-11-06,121,109,12,11.01
1950,1950-11-07,118,106,12,11.32
1950,1950-11-08,86,79,7,8.86
1950,1950-11-09,80,82,-2,-2.44
1950,1950-11-10,79,70,9,12.86
1950,1950-11-11,82,77,5,6.49
1950,1950-11-12,52,66,-14,-21.21
1950,1950-11-13,59,66,-7,-10.61
1950,1950-11-14,101,87,14,16.09
1950,1950-11-15,108,100,8,8
1950,1950-11-16,81,77,4,5.19
1950,1950-11-17,64,71,-7,-9.86
1950,1950-11-18,47,61,-14,-22.95
1950,1950-11-19,49,56,-7,-12.5
1950,1950-11-20,33,40,-7,-17.5
1950,1950-11-21,12,19,-7,-36.84
1950,1950-11-22,11,24,-13,-54.17
1950,1950-11-23,18,21,-3,-14.29
1950,1950-11-24,16,16,0,0
1950,1950-11-27,103,102,1,0.98
1950,1950-11-28,107,108,-1,-0.93
1950,1950-11-29,105,108,-3,-2.78
1950,1950-12-01,119,137,-18,-13.14
1950,1950-12-02,118,129,-11,-8.53
1950,1950-12-05,77,89,-12,-13.48
1950,1950-12-06,65,68,-3,-4.41
1950,1950-12-07,129,120,9,7.5
1950,1950-12-08,148,134,14,10.45
1950,1950-12-09,137,151,-14,-9.27
1950,1950-12-10,122,148,-26,-17.57
1950,1950-12-11,115,156,-41,-26.28
1950,1950-12-13,85,113,-28,-24.78
1950,1950-12-15,55,59,-4,-6.78
1950,1950-12-16,23,43,-20,-46.51
1950,1950-12-17,17,25,-8,-32
1950,1950-12-18,11,19,-8,-42.11
1950,1950-12-19,0,7,-7,-100
1950,1950-12-20,0,3,-3,-100
1950,1950-12-21,0,3,-3,-100
1950,1950-12-22,0,3,-3,-100
1950,1950-12-23,0,4,-4,-100
1950,1950-12-24,30,37,-7,-18.92
1950,1950-12-25,46,43,3,6.98
1950,1950-12-27,59,57,2,3.51
1950,1950-12-28,49,39,10,25.64
1950,1950-12-29,23,35,-12,-34.29
1950,1950-12-31,14,28,-14,-50
1951,1951-01-01,23,22,1,4.55
1951,1951-01-03,30,38,-8,-21.05
1951,1951-01-04,31,26,5,19.23
1951,1951-01-05,50,43,7,16.28
1951,1951-01-06,65,44,21,47.73
1951,1951-01-07,54,43,11,25.58
1951,1951-01-08,54,39,15,38.46
1951,1951-01-09,80,53,27,50.94
1951,1951-01-10,49,39,10,25.64
1951,1951-01-12,13,29,-16,-55.17
1951,1951-01-13,13,16,-3,-18.75
1951,1951-01-14,12,18,-6,-33.33
1951,1951-01-15,15,14,1,7.14
1951,1951-01-16,28,19,9,47.37
1951,1951-01-17,44,30,14,46.67
1951,1951-01-19,54,54,0,0
1951,1951-01-20,53,50,3,6
1951,1951-01-21,36,43,-7,-16.28
1951,1951-01-22,48,52,-4,-7.69
1951,1951-01-23,100,72,28,38.89
1951,1951-01-24,131,68,63,92.65
1951,1951-01-25,115,73,42,57.53
1951,1951-01-26,190,104,86,82.69
1951,1951-01-29,178,95,83,87.37
1951,1951-01-30,158,119,39,32.77
1951,1951-01-31,143,121,22,18.18
1951,1951-02-01,112,94,18,19.15
1951,1951-02-02,102,70,32,45.71
1951,1951-02-03,53,52,1,1.92
1951,1951-02-04,64,63,1,1.59
1951,1951-02-05,24,48,-24,-50
1951,1951-02-06,26,31,-5,-16.13
1951,1951-02-07,49,34,15,44.12
1951,1951-02-08,24,41,-17,-41.46
1951,1951-02-09,76,62,14,22.58
1951,1951-02-10,110,84,26,30.95
1951,1951-02-11,87,80,7,8.75
1951,1951-02-12,71,78,-7,-8.97
1951,1951-02-13,37,52,-15,-28.85
1951,1951-02-14,55,63,-8,-12.7
1951,1951-02-15,83,69,14,20.29
1951,1951-02-16,44,52,-8,-15.38
1951,1951-02-17,38,40,-2,-5
1951,1951-02-18,38,33,5,15.15
1951,1951-02-19,41,32,9,28.12
1951,1951-02-20,57,35,22,62.86
1951,1951-02-21,83,45,38,84.44
1951,1951-02-22,65,41,24,58.54
1951,1951-02-23,36,48,-12,-25
1951,1951-02-24,91,53,38,71.7
1951,1951-02-25,88,56,32,57.14
1951,1951-02-26,63,53,10,18.87
1951,1951-02-27,51,48,3,6.25
1951,1951-02-28,57,54,3,5.56
1951,1951-03-01,46,62,-16,-25.81
1951,1951-03-02,52,48,4,8.33
1951,1951-03-03,31,47,-16,-34.04
1951,1951-03-04,13,43,-30,-69.77
1951,1951-03-05,48,33,15,45.45
1951,1951-03-06,70,56,14,25
1951,1951-03-07,58,43,15,34.88
1951,1951-03-08,24,21,3,14.29
1951,1951-03-09,29,22,7,31.82
1951,1951-03-10,25,27,-2,-7.41
1951,1951-03-11,39,35,4,11.43
1951,1951-03-12,49,41,8,19.51
1951,1951-03-13,45,38,7,18.42
1951,1951-03-14,41,33,8,24.24
1951,1951-03-15,34,34,0,0
1951,1951-03-16,40,33,7,21.21
1951,1951-03-17,39,35,4,11.43
1951,1951-03-18,40,31,9,29.03
1951,1951-03-19,50,37,13,35.14
1951,1951-03-20,39,39,0,0
1951,1951-03-21,45,43,2,4.65
1951,1951-03-22,53,57,-4,-7.02
1951,1951-03-23,91,71,20,28.17
1951,1951-03-24,159,105,54,51.43
1951,1951-03-25,136,96,40,41.67
1951,1951-03-26,86,83,3,3.61
1951,1951-03-27,119,93,26,27.96
1951,1951-03-28,96,71,25,35.21
1951,1951-03-31,46,34,12,35.29
1951,1951-04-01,41,36,5,13.89
1951,1951-04-02,36,33,3,9.09
1951,1951-04-04,26,28,-2,-7.14
1951,1951-04-05,57,58,-1,-1.72
1951,1951-04-06,79,65,14,21.54
1951,1951-04-07,94,79,15,18.99
1951,1951-04-08,86,81,5,6.17
1951,1951-04-10,103,92,11,11.96
1951,1951-04-11,85,91,-6,-6.59
1951,1951-04-12,101,85,16,18.82
1951,1951-04-13,106,82,24,29.27
1951,1951-04-15,121,98,23,23.47
1951,1951-04-17,123,114,9,7.89
1951,1951-04-18,129,120,9,7.5
1951,1951-04-20,105,114,-9,-7.89
1951,1951-04-21,150,145,5,3.45
1951,1951-04-22,200,140,60,42.86
1951,1951-04-23,141,130,11,8.46
1951,1951-04-24,150,119,31,26.05
1951,1951-04-26,113,103,10,9.71
1951,1951-04-27,139,117,22,18.8
1951,1951-04-28,103,104,-1,-0.96
1951,1951-04-29,98,80,18,22.5
1951,1951-04-30,108,80,28,35
1951,1951-05-01,81,63,18,28.57
1951,1951-05-02,69,55,14,25.45
1951,1951-05-03,57,42,15,35.71
1951,1951-05-04,47,37,10,27.03
1951,1951-05-05,25,24,1,4.17
1951,1951-05-06,16,19,-3,-15.79
1951,1951-05-07,24,27,-3,-11.11
1951,1951-05-08,14,16,-2,-12.5
1951,1951-05-09,37,29,8,27.59
1951,1951-05-10,90,67,23,34.33
1951,1951-05-11,133,87,46,52.87
1951,1951-05-12,179,121,58,47.93
1951,1951-05-15,170,153,17,11.11
1951,1951-05-16,214,161,53,32.92
1951,1951-05-17,222,179,43,24.02
1951,1951-05-18,213,185,28,15.14
1951,1951-05-19,177,178,-1,-0.56
1951,1951-05-23,164,113,51,45.13
1951,1951-05-24,161,101,60,59.41
1951,1951-05-25,132,95,37,38.95
1951,1951-05-26,117,95,22,23.16
1951,1951-05-27,124,85,39,45.88
1951,1951-05-28,101,74,27,36.49
1951,1951-05-29,77,36,41,113.89
1951,1951-05-30,49,40,9,22.5
1951,1951-05-31,37,37,0,0
1951,1951-06-01,44,38,6,15.79
1951,1951-06-02,38,38,0,0
1951,1951-06-03,21,30,-9,-30
1951,1951-06-04,27,28,-1,-3.57
1951,1951-06-05,54,67,-13,-19.4
1951,1951-06-06,120,92,28,30.43
1951,1951-06-07,140,107,33,30.84
1951,1951-06-08,117,118,-1,-0.85
1951,1951-06-09,186,135,51,37.78
1951,1951-06-10,138,111,27,24.32
1951,1951-06-11,166,114,52,45.61
1951,1951-06-13,146,120,26,21.67
1951,1951-06-14,143,117,26,22.22
1951,1951-06-15,132,108,24,22.22
1951,1951-06-16,143,125,18,14.4
1951,1951-06-17,188,129,59,45.74
1951,1951-06-18,179,125,54,43.2
1951,1951-06-19,154,124,30,24.19
1951,1951-06-20,150,99,51,51.52
1951,1951-06-21,152,109,43,39.45
1951,1951-06-22,128,108,20,18.52
1951,1951-06-23,109,80,29,36.25
1951,1951-06-24,69,68,1,1.47
1951,1951-06-25,91,60,31,51.67
1951,1951-06-26,41,54,-13,-24.07
1951,1951-06-28,45,44,1,2.27
1951,1951-06-29,52,29,23,79.31
1951,1951-06-30,19,18,1,5.56
1951,1951-07-01,12,17,-5,-29.41
1951,1951-07-02,36,27,9,33.33
1951,1951-07-03,35,38,-3,-7.89
1951,1951-07-04,51,44,7,15.91
1951,1951-07-05,47,42,5,11.9
1951,1951-07-06,68,70,-2,-2.86
1951,1951-07-07,98,85,13,15.29
1951,1951-07-08,104,89,15,16.85
1951,1951-07-09,112,90,22,24.44
1951,1951-07-10,111,95,16,16.84
1951,1951-07-11,116,87,29,33.33
1951,1951-07-12,111,69,42,60.87
1951,1951-07-13,103,77,26,33.77
1951,1951-07-14,81,71,10,14.08
1951,1951-07-15,65,71,-6,-8.45
1951,1951-07-16,69,47,22,46.81
1951,1951-07-18,33,34,-1,-2.94
1951,1951-07-20,41,31,10,32.26
1951,1951-07-21,21,19,2,10.53
1951,1951-07-22,43,36,7,19.44
1951,1951-07-23,121,72,49,68.06
1951,1951-07-24,86,74,12,16.22
1951,1951-07-25,72,67,5,7.46
1951,1951-07-26,81,66,15,22.73
1951,1951-07-27,70,67,3,4.48
1951,1951-07-28,72,81,-9,-11.11
1951,1951-07-29,32,47,-15,-31.91
1951,1951-07-30,29,56,-27,-48.21
1951,1951-07-31,68,62,6,9.68
1951,1951-08-01,49,55,-6,-10.91
1951,1951-08-02,49,51,-2,-3.92
1951,1951-08-03,51,49,2,4.08
1951,1951-08-04,72,64,8,12.5
1951,1951-08-05,84,74,10,13.51
1951,1951-08-06,118,87,31,35.63
1951,1951-08-07,117,95,22,23.16
1951,1951-08-08,118,99,19,19.19
1951,1951-08-17,59,45,14,31.11
1951,1951-08-18,47,54,-7,-12.96
1951,1951-08-19,69,61,8,13.11
1951,1951-08-20,83,49,34,69.39
1951,1951-08-21,51,45,6,13.33
1951,1951-08-22,44,47,-3,-6.38
1951,1951-08-23,35,40,-5,-12.5
1951,1951-08-24,29,28,1,3.57
1951,1951-08-25,13,8,5,62.5
1951,1951-08-26,6,12,-6,-50
1951,1951-08-27,0,0,0,NA
1951,1951-08-28,15,9,6,66.67
1951,1951-08-29,26,11,15,136.36
1951,1951-08-30,11,16,-5,-31.25
1951,1951-08-31,51,30,21,70
1951,1951-09-01,61,43,18,41.86
1951,1951-09-02,47,45,2,4.44
1951,1951-09-03,69,53,16,30.19
1951,1951-09-04,65,57,8,14.04
1951,1951-09-05,79,64,15,23.44
1951,1951-09-06,92,78,14,17.95
1951,1951-09-07,77,65,12,18.46
1951,1951-09-08,86,98,-12,-12.24
1951,1951-09-09,111,114,-3,-2.63
1951,1951-09-10,146,113,33,29.2
1951,1951-09-11,153,117,36,30.77
1951,1951-09-13,97,121,-24,-19.83
1951,1951-09-14,141,115,26,22.61
1951,1951-09-15,97,111,-14,-12.61
1951,1951-09-16,104,102,2,1.96
1951,1951-09-18,62,115,-53,-46.09
1951,1951-09-19,141,116,25,21.55
1951,1951-09-20,134,90,44,48.89
1951,1951-09-21,119,107,12,11.21
1951,1951-09-22,118,125,-7,-5.6
1951,1951-09-23,149,112,37,33.04
1951,1951-09-24,146,95,51,53.68
1951,1951-09-26,75,62,13,20.97
1951,1951-09-27,63,62,1,1.61
1951,1951-09-28,52,42,10,23.81
1951,1951-09-29,17,20,-3,-15
1951,1951-09-30,40,30,10,33.33
1951,1951-10-01,52,44,8,18.18
1951,1951-10-02,60,50,10,20
1951,1951-10-03,58,46,12,26.09
1951,1951-10-04,43,41,2,4.88
1951,1951-10-05,24,25,-1,-4
1951,1951-10-06,17,20,-3,-15
1951,1951-10-07,23,13,10,76.92
1951,1951-10-08,23,36,-13,-36.11
1951,1951-10-09,64,61,3,4.92
1951,1951-10-10,67,77,-10,-12.99
1951,1951-10-12,96,88,8,9.09
1951,1951-10-13,82,65,17,26.15
1951,1951-10-14,61,56,5,8.93
1951,1951-10-15,62,55,7,12.73
1951,1951-10-16,72,61,11,18.03
1951,1951-10-17,68,62,6,9.68
1951,1951-10-18,62,58,4,6.9
1951,1951-10-19,90,64,26,40.62
1951,1951-10-20,36,45,-9,-20
1951,1951-10-21,34,32,2,6.25
1951,1951-10-22,36,29,7,24.14
1951,1951-10-23,22,15,7,46.67
1951,1951-10-24,13,21,-8,-38.1
1951,1951-10-25,26,28,-2,-7.14
1951,1951-10-26,53,45,8,17.78
1951,1951-10-27,43,56,-13,-23.21
1951,1951-10-28,84,71,13,18.31
1951,1951-10-29,101,77,24,31.17
1951,1951-11-02,46,51,-5,-9.8
1951,1951-11-03,54,50,4,8
1951,1951-11-05,62,65,-3,-4.62
1951,1951-11-06,60,56,4,7.14
1951,1951-11-07,27,43,-16,-37.21
1951,1951-11-08,43,36,7,19.44
1951,1951-11-09,62,59,3,5.08
1951,1951-11-10,96,72,24,33.33
1951,1951-11-11,71,63,8,12.7
1951,1951-11-12,71,54,17,31.48
1951,1951-11-13,30,43,-13,-30.23
1951,1951-11-14,53,48,5,10.42
1951,1951-11-15,62,61,1,1.64
1951,1951-11-16,52,42,10,23.81
1951,1951-11-17,65,62,3,4.84
1951,1951-11-18,59,56,3,5.36
1951,1951-11-19,57,60,-3,-5
1951,1951-11-21,42,45,-3,-6.67
1951,1951-11-23,64,56,8,14.29
1951,1951-11-24,75,62,13,20.97
1951,1951-11-25,83,79,4,5.06
1951,1951-11-26,76,74,2,2.7
1951,1951-11-27,79,71,8,11.27
1951,1951-11-28,74,63,11,17.46
1951,1951-11-29,67,70,-3,-4.29
1951,1951-11-30,38,45,-7,-15.56
1951,1951-12-01,41,29,12,41.38
1951,1951-12-02,24,28,-4,-14.29
1951,1951-12-03,28,28,0,0
1951,1951-12-05,0,46,-46,-100
1951,1951-12-07,30,44,-14,-31.82
1951,1951-12-08,28,41,-13,-31.71
1951,1951-12-09,27,25,2,8
1951,1951-12-10,14,28,-14,-50
1951,1951-12-13,28,30,-2,-6.67
1951,1951-12-14,39,34,5,14.71
1951,1951-12-15,37,36,1,2.78
1951,1951-12-17,53,47,6,12.77
1951,1951-12-19,88,62,26,41.94
1951,1951-12-20,81,97,-16,-16.49
1951,1951-12-22,66,66,0,0
1951,1951-12-23,70,71,-1,-1.41
1951,1951-12-24,68,67,1,1.49
1951,1951-12-26,46,46,0,0
1951,1951-12-27,25,27,-2,-7.41
1951,1951-12-30,63,45,18,40
1951,1951-12-31,56,57,-1,-1.75
1952,1952-01-01,91,61,30,49.18
1952,1952-01-02,31,60,-29,-48.33
1952,1952-01-03,42,43,-1,-2.33
1952,1952-01-04,23,26,-3,-11.54
1952,1952-01-05,12,30,-18,-60
1952,1952-01-06,0,14,-14,-100
1952,1952-01-07,13,14,-1,-7.14
1952,1952-01-08,13,25,-12,-48
1952,1952-01-09,42,47,-5,-10.64
1952,1952-01-11,43,54,-11,-20.37
1952,1952-01-13,58,55,3,5.45
1952,1952-01-16,44,67,-23,-34.33
1952,1952-01-18,49,53,-4,-7.55
1952,1952-01-19,33,42,-9,-21.43
1952,1952-01-20,35,39,-4,-10.26
1952,1952-01-21,16,39,-23,-58.97
1952,1952-01-22,12,12,0,0
1952,1952-01-26,22,26,-4,-15.38
1952,1952-01-27,26,24,2,8.33
1952,1952-01-28,16,25,-9,-36
1952,1952-01-30,14,26,-12,-46.15
1952,1952-01-31,13,18,-5,-27.78
1952,1952-02-01,11,13,-2,-15.38
1952,1952-02-02,11,12,-1,-8.33
1952,1952-02-03,0,0,0,NA
1952,1952-02-04,0,14,-14,-100
1952,1952-02-05,31,41,-10,-24.39
1952,1952-02-06,45,38,7,18.42
1952,1952-02-07,34,31,3,9.68
1952,1952-02-08,25,25,0,0
1952,1952-02-09,29,28,1,3.57
1952,1952-02-10,13,17,-4,-23.53
1952,1952-02-11,0,0,0,NA
1952,1952-02-12,31,15,16,106.67
1952,1952-02-13,24,22,2,9.09
1952,1952-02-14,38,33,5,15.15
1952,1952-02-15,56,40,16,40
1952,1952-02-17,59,45,14,31.11
1952,1952-02-18,67,47,20,42.55
1952,1952-02-19,45,39,6,15.38
1952,1952-02-21,30,29,1,3.45
1952,1952-02-22,34,25,9,36
1952,1952-02-23,24,28,-4,-14.29
1952,1952-02-24,22,15,7,46.67
1952,1952-02-25,0,0,0,NA
1952,1952-02-26,0,0,0,NA
1952,1952-02-27,0,0,0,NA
1952,1952-02-28,0,0,0,NA
1952,1952-03-02,0,0,0,NA
1952,1952-03-03,0,0,0,NA
1952,1952-03-05,12,8,4,50
1952,1952-03-06,12,11,1,9.09
1952,1952-03-08,12,13,-1,-7.69
1952,1952-03-09,8,14,-6,-42.86
1952,1952-03-11,23,30,-7,-23.33
1952,1952-03-12,32,34,-2,-5.88
1952,1952-03-13,27,30,-3,-10
1952,1952-03-15,30,26,4,15.38
1952,1952-03-16,22,20,2,10
1952,1952-03-17,12,16,-4,-25
1952,1952-03-18,12,14,-2,-14.29
1952,1952-03-20,0,0,0,NA
1952,1952-03-25,34,31,3,9.68
1952,1952-03-26,36,35,1,2.86
1952,1952-03-27,59,56,3,5.36
1952,1952-03-28,100,85,15,17.65
1952,1952-03-29,76,80,-4,-5
1952,1952-03-30,99,85,14,16.47
1952,1952-03-31,62,44,18,40.91
1952,1952-04-01,29,25,4,16
1952,1952-04-02,23,19,4,21.05
1952,1952-04-03,33,25,8,32
1952,1952-04-04,38,28,10,35.71
1952,1952-04-06,40,27,13,48.15
1952,1952-04-08,27,29,-2,-6.9
1952,1952-04-10,39,30,9,30
1952,1952-04-11,49,35,14,40
1952,1952-04-12,32,21,11,52.38
1952,1952-04-14,17,10,7,70
1952,1952-04-15,0,2,-2,-100
1952,1952-04-16,0,5,-5,-100
1952,1952-04-17,0,11,-11,-100
1952,1952-04-18,21,20,1,5
1952,1952-04-19,52,36,16,44.44
1952,1952-04-20,58,44,14,31.82
1952,1952-04-21,64,55,9,16.36
1952,1952-04-22,66,50,16,32
1952,1952-04-23,30,31,-1,-3.23
1952,1952-04-24,30,26,4,15.38
1952,1952-04-27,13,21,-8,-38.1
1952,1952-04-30,37,40,-3,-7.5
1952,1952-05-01,22,28,-6,-21.43
1952,1952-05-02,18,19,-1,-5.26
1952,1952-05-03,12,13,-1,-7.69
1952,1952-05-04,35,30,5,16.67
1952,1952-05-05,31,30,1,3.33
1952,1952-05-06,46,38,8,21.05
1952,1952-05-07,31,27,4,14.81
1952,1952-05-08,23,14,9,64.29
1952,1952-05-09,13,9,4,44.44
1952,1952-05-10,0,0,0,NA
1952,1952-05-11,0,4,-4,-100
1952,1952-05-12,0,2,-2,-100
1952,1952-05-13,14,9,5,55.56
1952,1952-05-14,19,7,12,171.43
1952,1952-05-16,11,13,-2,-15.38
1952,1952-05-17,16,15,1,6.67
1952,1952-05-18,24,24,0,0
1952,1952-05-19,27,25,2,8
1952,1952-05-20,14,28,-14,-50
1952,1952-05-21,29,31,-2,-6.45
1952,1952-05-22,34,33,1,3.03
1952,1952-05-23,30,32,-2,-6.25
1952,1952-05-24,11,26,-15,-57.69
1952,1952-05-25,12,16,-4,-25
1952,1952-05-27,65,54,11,20.37
1952,1952-05-28,52,50,2,4
1952,1952-05-29,49,40,9,22.5
1952,1952-05-30,31,27,4,14.81
1952,1952-05-31,13,16,-3,-18.75
1952,1952-06-01,25,19,6,31.58
1952,1952-06-02,25,18,7,38.89
1952,1952-06-03,0,7,-7,-100
1952,1952-06-04,0,2,-2,-100
1952,1952-06-06,0,5,-5,-100
1952,1952-06-07,21,23,-2,-8.7
1952,1952-06-08,8,10,-2,-20
1952,1952-06-09,13,11,2,18.18
1952,1952-06-10,16,13,3,23.08
1952,1952-06-11,12,15,-3,-20
1952,1952-06-12,24,18,6,33.33
1952,1952-06-13,27,19,8,42.11
1952,1952-06-14,31,27,4,14.81
1952,1952-06-16,49,41,8,19.51
1952,1952-06-17,52,52,0,0
1952,1952-06-18,66,60,6,10
1952,1952-06-19,68,62,6,9.68
1952,1952-06-20,70,62,8,12.9
1952,1952-06-21,61,60,1,1.67
1952,1952-06-22,63,67,-4,-5.97
1952,1952-06-24,63,52,11,21.15
1952,1952-06-25,54,44,10,22.73
1952,1952-06-27,41,52,-11,-21.15
1952,1952-06-29,80,60,20,33.33
1952,1952-06-30,76,66,10,15.15
1952,1952-07-01,46,47,-1,-2.13
1952,1952-07-02,49,46,3,6.52
1952,1952-07-03,29,37,-8,-21.62
1952,1952-07-04,39,31,8,25.81
1952,1952-07-05,19,21,-2,-9.52
1952,1952-07-06,13,20,-7,-35
1952,1952-07-07,21,18,3,16.67
1952,1952-07-08,11,31,-20,-64.52
1952,1952-07-09,70,44,26,59.09
1952,1952-07-10,78,56,22,39.29
1952,1952-07-11,81,59,22,37.29
1952,1952-07-12,76,60,16,26.67
1952,1952-07-13,87,69,18,26.09
1952,1952-07-14,119,89,30,33.71
1952,1952-07-15,104,139,-35,-25.18
1952,1952-07-16,98,74,24,32.43
1952,1952-07-17,53,47,6,12.77
1952,1952-07-18,48,33,15,45.45
1952,1952-07-19,28,28,0,0
1952,1952-07-20,39,32,7,21.88
1952,1952-07-21,22,19,3,15.79
1952,1952-07-22,11,10,1,10
1952,1952-07-23,12,11,1,9.09
1952,1952-07-24,11,10,1,10
1952,1952-07-25,21,19,2,10.53
1952,1952-07-26,14,13,1,7.69
1952,1952-07-27,25,23,2,8.7
1952,1952-07-28,32,25,7,28
1952,1952-07-29,35,27,8,29.63
1952,1952-07-30,39,33,6,18.18
1952,1952-07-31,100,52,48,92.31
1952,1952-08-01,58,36,22,61.11
1952,1952-08-02,35,32,3,9.38
1952,1952-08-03,39,38,1,2.63
1952,1952-08-04,61,46,15,32.61
1952,1952-08-05,71,46,25,54.35
1952,1952-08-06,53,43,10,23.26
1952,1952-08-07,77,52,25,48.08
1952,1952-08-08,64,57,7,12.28
1952,1952-08-09,65,59,6,10.17
1952,1952-08-10,57,54,3,5.56
1952,1952-08-11,51,46,5,10.87
1952,1952-08-12,70,58,12,20.69
1952,1952-08-13,74,53,21,39.62
1952,1952-08-14,60,49,11,22.45
1952,1952-08-15,55,45,10,22.22
1952,1952-08-17,58,46,12,26.09
1952,1952-08-18,52,41,11,26.83
1952,1952-08-19,46,32,14,43.75
1952,1952-08-20,36,26,10,38.46
1952,1952-08-21,43,31,12,38.71
1952,1952-08-22,63,40,23,57.5
1952,1952-08-23,110,58,52,89.66
1952,1952-08-24,58,59,-1,-1.69
1952,1952-08-25,86,66,20,30.3
1952,1952-08-26,113,72,41,56.94
1952,1952-08-27,142,93,49,52.69
1952,1952-08-28,145,81,64,79.01
1952,1952-08-30,101,85,16,18.82
1952,1952-08-31,110,89,21,23.6
1952,1952-09-01,87,75,12,16
1952,1952-09-02,92,62,30,48.39
1952,1952-09-03,64,44,20,45.45
1952,1952-09-04,36,30,6,20
1952,1952-09-05,55,39,16,41.03
1952,1952-09-06,46,41,5,12.2
1952,1952-09-07,25,26,-1,-3.85
1952,1952-09-08,0,1,-1,-100
1952,1952-09-09,19,10,9,90
1952,1952-09-10,14,8,6,75
1952,1952-09-11,0,0,0,NA
1952,1952-09-12,6,1,5,500
1952,1952-09-13,0,0,0,NA
1952,1952-09-14,0,0,0,NA
1952,1952-09-15,11,1,10,1000
1952,1952-09-16,30,8,22,275
1952,1952-09-17,33,15,18,120
1952,1952-09-18,54,19,35,184.21
1952,1952-09-20,32,25,7,28
1952,1952-09-21,38,32,6,18.75
1952,1952-09-22,38,33,5,15.15
1952,1952-09-23,66,42,24,57.14
1952,1952-09-24,63,47,16,34.04
1952,1952-09-25,51,41,10,24.39
1952,1952-09-26,60,42,18,42.86
1952,1952-09-27,41,33,8,24.24
1952,1952-09-28,41,31,10,32.26
1952,1952-09-29,24,29,-5,-17.24
1952,1952-09-30,19,20,-1,-5
1952,1952-10-01,12,17,-5,-29.41
1952,1952-10-02,11,20,-9,-45
1952,1952-10-03,35,22,13,59.09
1952,1952-10-04,35,33,2,6.06
1952,1952-10-05,40,34,6,17.65
1952,1952-10-06,64,41,23,56.1
1952,1952-10-07,31,25,6,24
1952,1952-10-08,26,23,3,13.04
1952,1952-10-09,21,17,4,23.53
1952,1952-10-10,12,16,-4,-25
1952,1952-10-11,16,15,1,6.67
1952,1952-10-12,18,17,1,5.88
1952,1952-10-13,16,16,0,0
1952,1952-10-14,15,15,0,0
1952,1952-10-15,16,13,3,23.08
1952,1952-10-16,13,9,4,44.44
1952,1952-10-17,0,0,0,NA
1952,1952-10-18,0,0,0,NA
1952,1952-10-19,19,14,5,35.71
1952,1952-10-20,21,18,3,16.67
1952,1952-10-21,26,21,5,23.81
1952,1952-10-22,34,25,9,36
1952,1952-10-23,34,29,5,17.24
1952,1952-10-24,39,28,11,39.29
1952,1952-10-25,49,34,15,44.12
1952,1952-10-26,34,26,8,30.77
1952,1952-10-27,46,38,8,21.05
1952,1952-10-29,36,33,3,9.09
1952,1952-10-31,21,20,1,5
1952,1952-11-01,25,19,6,31.58
1952,1952-11-02,0,10,-10,-100
1952,1952-11-03,0,0,0,NA
1952,1952-11-04,0,0,0,NA
1952,1952-11-05,15,11,4,36.36
1952,1952-11-06,18,16,2,12.5
1952,1952-11-07,17,34,-17,-50
1952,1952-11-08,45,40,5,12.5
1952,1952-11-09,48,33,15,45.45
1952,1952-11-10,33,26,7,26.92
1952,1952-11-12,24,20,4,20
1952,1952-11-14,27,26,1,3.85
1952,1952-11-16,21,19,2,10.53
1952,1952-11-18,47,33,14,42.42
1952,1952-11-19,44,38,6,15.79
1952,1952-11-20,50,44,6,13.64
1952,1952-11-23,40,28,12,42.86
1952,1952-11-24,54,35,19,54.29
1952,1952-11-25,27,24,3,12.5
1952,1952-11-26,19,20,-1,-5
1952,1952-11-27,15,15,0,0
1952,1952-11-28,0,4,-4,-100
1952,1952-11-29,7,5,2,40
1952,1952-11-30,11,12,-1,-8.33
1952,1952-12-01,12,11,1,9.09
1952,1952-12-03,11,14,-3,-21.43
1952,1952-12-04,22,15,7,46.67
1952,1952-12-05,25,29,-4,-13.79
1952,1952-12-06,50,36,14,38.89
1952,1952-12-07,42,39,3,7.69
1952,1952-12-08,81,51,30,58.82
1952,1952-12-09,59,29,30,103.45
1952,1952-12-10,37,25,12,48
1952,1952-12-11,44,33,11,33.33
1952,1952-12-12,53,53,0,0
1952,1952-12-13,72,53,19,35.85
1952,1952-12-14,90,65,25,38.46
1952,1952-12-15,86,66,20,30.3
1952,1952-12-17,81,68,13,19.12
1952,1952-12-19,79,59,20,33.9
1952,1952-12-20,49,45,4,8.89
1952,1952-12-21,38,40,-2,-5
1952,1952-12-22,23,28,-5,-17.86
1952,1952-12-23,23,25,-2,-8
1952,1952-12-27,0,7,-7,-100
1952,1952-12-28,0,0,0,NA
1952,1952-12-29,0,3,-3,-100
1953,1953-01-01,16,17,-1,-5.88
1953,1953-01-04,29,27,2,7.41
1953,1953-01-05,32,31,1,3.23
1953,1953-01-08,31,36,-5,-13.89
1953,1953-01-09,69,48,21,43.75
1953,1953-01-10,85,57,28,49.12
1953,1953-01-11,92,65,27,41.54
1953,1953-01-12,75,60,15,25
1953,1953-01-14,62,50,12,24
1953,1953-01-15,58,49,9,18.37
1953,1953-01-16,49,49,0,0
1953,1953-01-17,47,35,12,34.29
1953,1953-01-18,35,26,9,34.62
1953,1953-01-19,29,23,6,26.09
1953,1953-01-20,22,22,0,0
1953,1953-01-21,22,14,8,57.14
1953,1953-01-22,22,19,3,15.79
1953,1953-01-23,11,11,0,0
1953,1953-01-25,0,3,-3,-100
1953,1953-01-26,0,1,-1,-100
1953,1953-01-27,0,0,0,NA
1953,1953-01-28,0,0,0,NA
1953,1953-01-29,0,3,-3,-100
1953,1953-01-30,0,0,0,NA
1953,1953-01-31,0,0,0,NA
1953,1953-02-01,0,1,-1,-100
1953,1953-02-02,18,9,9,100
1953,1953-02-03,12,10,2,20
1953,1953-02-05,11,1,10,1000
1953,1953-02-06,11,12,-1,-8.33
1953,1953-02-07,11,13,-2,-15.38
1953,1953-02-08,11,11,0,0
1953,1953-02-09,11,13,-2,-15.38
1953,1953-02-10,11,10,1,10
1953,1953-02-11,12,8,4,50
1953,1953-02-12,0,2,-2,-100
1953,1953-02-13,0,1,-1,-100
1953,1953-02-14,0,0,0,NA
1953,1953-02-15,0,1,-1,-100
1953,1953-02-16,0,0,0,NA
1953,1953-02-17,0,0,0,NA
1953,1953-02-19,0,0,0,NA
1953,1953-02-20,0,0,0,NA
1953,1953-02-21,0,0,0,NA
1953,1953-02-22,0,0,0,NA
1953,1953-02-23,0,0,0,NA
1953,1953-02-24,0,0,0,NA
1953,1953-02-25,0,0,0,NA
1953,1953-02-26,0,0,0,NA
1953,1953-02-27,0,0,0,NA
1953,1953-02-28,0,0,0,NA
1953,1953-03-01,0,0,0,NA
1953,1953-03-02,0,0,0,NA
1953,1953-03-03,0,1,-1,-100
1953,1953-03-04,0,4,-4,-100
1953,1953-03-05,0,0,0,NA
1953,1953-03-06,0,0,0,NA
1953,1953-03-07,0,0,0,NA
1953,1953-03-08,0,2,-2,-100
1953,1953-03-09,0,0,0,NA
1953,1953-03-10,0,0,0,NA
1953,1953-03-11,0,0,0,NA
1953,1953-03-12,0,0,0,NA
1953,1953-03-13,0,2,-2,-100
1953,1953-03-14,8,7,1,14.29
1953,1953-03-15,0,3,-3,-100
1953,1953-03-16,0,0,0,NA
1953,1953-03-17,0,0,0,NA
1953,1953-03-18,0,3,-3,-100
1953,1953-03-19,11,11,0,0
1953,1953-03-20,11,11,0,0
1953,1953-03-21,13,12,1,8.33
1953,1953-03-22,12,11,1,9.09
1953,1953-03-23,11,12,-1,-8.33
1953,1953-03-24,11,12,-1,-8.33
1953,1953-03-25,0,3,-3,-100
1953,1953-03-26,0,0,0,NA
1953,1953-03-27,13,18,-5,-27.78
1953,1953-03-28,24,21,3,14.29
1953,1953-03-29,27,20,7,35
1953,1953-03-30,67,48,19,39.58
1953,1953-03-31,57,44,13,29.55
1953,1953-04-01,42,43,-1,-2.33
1953,1953-04-02,51,50,1,2
1953,1953-04-03,66,55,11,20
1953,1953-04-04,74,51,23,45.1
1953,1953-04-05,46,36,10,27.78
1953,1953-04-06,50,34,16,47.06
1953,1953-04-07,74,46,28,60.87
1953,1953-04-08,63,37,26,70.27
1953,1953-04-09,41,26,15,57.69
1953,1953-04-10,38,15,23,153.33
1953,1953-04-11,7,4,3,75
1953,1953-04-12,0,0,0,NA
1953,1953-04-13,0,0,0,NA
1953,1953-04-14,0,0,0,NA
1953,1953-04-15,0,0,0,NA
1953,1953-04-16,0,0,0,NA
1953,1953-04-17,0,0,0,NA
1953,1953-04-18,0,0,0,NA
1953,1953-04-19,0,0,0,NA
1953,1953-04-20,0,0,0,NA
1953,1953-04-21,6,1,5,500
1953,1953-04-22,22,12,10,83.33
1953,1953-04-24,41,32,9,28.12
1953,1953-04-25,74,40,34,85
1953,1953-04-26,90,54,36,66.67
1953,1953-04-27,63,54,9,16.67
1953,1953-04-29,54,45,9,20
1953,1953-04-30,50,44,6,13.64
1953,1953-05-01,50,39,11,28.21
1953,1953-05-02,64,39,25,64.1
1953,1953-05-03,50,32,18,56.25
1953,1953-05-04,29,15,14,93.33
1953,1953-05-05,11,11,0,0
1953,1953-05-06,11,10,1,10
1953,1953-05-07,11,9,2,22.22
1953,1953-05-08,11,0,11,NA
1953,1953-05-09,0,0,0,NA
1953,1953-05-10,0,0,0,NA
1953,1953-05-11,0,0,0,NA
1953,1953-05-12,0,0,0,NA
1953,1953-05-13,0,0,0,NA
1953,1953-05-14,0,0,0,NA
1953,1953-05-15,0,1,-1,-100
1953,1953-05-16,0,0,0,NA
1953,1953-05-17,11,5,6,120
1953,1953-05-18,6,3,3,100
1953,1953-05-19,12,13,-1,-7.69
1953,1953-05-20,12,12,0,0
1953,1953-05-21,12,11,1,9.09
1953,1953-05-23,15,13,2,15.38
1953,1953-05-24,13,13,0,0
1953,1953-05-25,14,14,0,0
1953,1953-05-26,12,12,0,0
1953,1953-05-27,11,13,-2,-15.38
1953,1953-05-28,12,16,-4,-25
1953,1953-05-29,20,19,1,5.26
1953,1953-05-30,24,22,2,9.09
1953,1953-05-31,0,6,-6,-100
1953,1953-06-01,27,14,13,92.86
1953,1953-06-02,29,26,3,11.54
1953,1953-06-03,31,24,7,29.17
1953,1953-06-04,39,35,4,11.43
1953,1953-06-05,41,34,7,20.59
1953,1953-06-06,43,34,9,26.47
1953,1953-06-07,32,32,0,0
1953,1953-06-08,41,34,7,20.59
1953,1953-06-09,29,30,-1,-3.33
1953,1953-06-10,33,28,5,17.86
1953,1953-06-11,24,17,7,41.18
1953,1953-06-12,11,7,4,57.14
1953,1953-06-13,11,3,8,266.67
1953,1953-06-14,16,18,-2,-11.11
1953,1953-06-15,21,21,0,0
1953,1953-06-16,25,25,0,0
1953,1953-06-18,25,18,7,38.89
1953,1953-06-19,33,26,7,26.92
1953,1953-06-20,34,29,5,17.24
1953,1953-06-21,22,18,4,22.22
1953,1953-06-22,24,17,7,41.18
1953,1953-06-23,15,13,2,15.38
1953,1953-06-24,14,12,2,16.67
1953,1953-06-25,23,17,6,35.29
1953,1953-06-26,12,13,-1,-7.69
1953,1953-06-27,12,5,7,140
1953,1953-06-28,6,4,2,50
1953,1953-06-29,11,7,4,57.14
1953,1953-06-30,6,6,0,0
1953,1953-07-01,0,0,0,NA
1953,1953-07-02,6,4,2,50
1953,1953-07-03,0,0,0,NA
1953,1953-07-04,0,0,0,NA
1953,1953-07-05,0,0,0,NA
1953,1953-07-06,0,0,0,NA
1953,1953-07-07,0,0,0,NA
1953,1953-07-08,0,0,0,NA
1953,1953-07-09,10,8,2,25
1953,1953-07-10,17,15,2,13.33
1953,1953-07-11,15,15,0,0
1953,1953-07-13,27,17,10,58.82
1953,1953-07-15,20,21,-1,-4.76
1953,1953-07-16,18,17,1,5.88
1953,1953-07-17,22,17,5,29.41
1953,1953-07-18,22,16,6,37.5
1953,1953-07-19,14,13,1,7.69
1953,1953-07-20,12,11,1,9.09
1953,1953-07-21,6,4,2,50
1953,1953-07-22,0,0,0,NA
1953,1953-07-23,0,0,0,NA
1953,1953-07-24,0,0,0,NA
1953,1953-07-25,0,0,0,NA
1953,1953-07-26,0,0,0,NA
1953,1953-07-27,0,0,0,NA
1953,1953-07-28,0,0,0,NA
1953,1953-07-29,0,0,0,NA
1953,1953-07-30,0,0,0,NA
1953,1953-07-31,0,0,0,NA
1953,1953-08-01,0,0,0,NA
1953,1953-08-02,14,5,9,180
1953,1953-08-03,17,13,4,30.77
1953,1953-08-04,24,16,8,50
1953,1953-08-05,14,14,0,0
1953,1953-08-06,15,11,4,36.36
1953,1953-08-07,17,12,5,41.67
1953,1953-08-08,30,25,5,20
1953,1953-08-09,31,32,-1,-3.12
1953,1953-08-10,72,55,17,30.91
1953,1953-08-11,96,72,24,33.33
1953,1953-08-12,90,66,24,36.36
1953,1953-08-13,89,67,22,32.84
1953,1953-08-15,64,52,12,23.08
1953,1953-08-16,62,55,7,12.73
1953,1953-08-17,48,43,5,11.63
1953,1953-08-18,44,36,8,22.22
1953,1953-08-19,35,31,4,12.9
1953,1953-08-20,24,18,6,33.33
1953,1953-08-21,23,14,9,64.29
1953,1953-08-22,17,14,3,21.43
1953,1953-08-23,0,3,-3,-100
1953,1953-08-24,0,0,0,NA
1953,1953-08-25,0,0,0,NA
1953,1953-08-26,0,0,0,NA
1953,1953-08-27,0,1,-1,-100
1953,1953-08-28,0,1,-1,-100
1953,1953-08-29,0,0,0,NA
1953,1953-08-30,0,0,0,NA
1953,1953-08-31,0,0,0,NA
1953,1953-09-01,7,2,5,250
1953,1953-09-02,0,0,0,NA
1953,1953-09-03,0,0,0,NA
1953,1953-09-05,0,1,-1,-100
1953,1953-09-06,23,12,11,91.67
1953,1953-09-07,11,14,-3,-21.43
1953,1953-09-08,32,16,16,100
1953,1953-09-09,22,17,5,29.41
1953,1953-09-10,20,18,2,11.11
1953,1953-09-11,28,19,9,47.37
1953,1953-09-12,38,28,10,35.71
1953,1953-09-13,39,20,19,95
1953,1953-09-14,36,27,9,33.33
1953,1953-09-15,44,44,0,0
1953,1953-09-16,53,44,9,20.45
1953,1953-09-17,49,40,9,22.5
1953,1953-09-18,49,38,11,28.95
1953,1953-09-19,11,20,-9,-45
1953,1953-09-20,24,20,4,20
1953,1953-09-21,11,15,-4,-26.67
1953,1953-09-22,11,14,-3,-21.43
1953,1953-09-23,11,11,0,0
1953,1953-09-24,23,13,10,76.92
1953,1953-09-25,24,18,6,33.33
1953,1953-09-26,34,16,18,112.5
1953,1953-09-28,6,0,6,NA
1953,1953-09-29,7,0,7,NA
1953,1953-09-30,0,3,-3,-100
1953,1953-10-01,0,0,0,NA
1953,1953-10-02,0,0,0,NA
1953,1953-10-03,12,4,8,200
1953,1953-10-04,0,3,-3,-100
1953,1953-10-05,0,1,-1,-100
1953,1953-10-06,21,19,2,10.53
1953,1953-10-07,18,18,0,0
1953,1953-10-08,18,15,3,20
1953,1953-10-09,16,17,-1,-5.88
1953,1953-10-10,6,6,0,0
1953,1953-10-11,15,8,7,87.5
1953,1953-10-12,26,13,13,100
1953,1953-10-13,26,18,8,44.44
1953,1953-10-14,32,29,3,10.34
1953,1953-10-15,34,24,10,41.67
1953,1953-10-16,22,18,4,22.22
1953,1953-10-17,0,4,-4,-100
1953,1953-10-18,0,0,0,NA
1953,1953-10-19,0,0,0,NA
1953,1953-10-20,0,0,0,NA
1953,1953-10-21,0,0,0,NA
1953,1953-10-22,0,0,0,NA
1953,1953-10-23,0,1,-1,-100
1953,1953-10-24,0,0,0,NA
1953,1953-10-25,0,0,0,NA
1953,1953-10-26,13,13,0,0
1953,1953-10-27,8,4,4,100
1953,1953-10-29,0,0,0,NA
1953,1953-10-30,13,0,13,NA
1953,1953-10-31,15,7,8,114.29
1953,1953-11-01,16,13,3,23.08
1953,1953-11-02,15,12,3,25
1953,1953-11-03,12,13,-1,-7.69
1953,1953-11-04,0,4,-4,-100
1953,1953-11-05,0,1,-1,-100
1953,1953-11-06,0,0,0,NA
1953,1953-11-07,0,0,0,NA
1953,1953-11-08,0,1,-1,-100
1953,1953-11-09,0,0,0,NA
1953,1953-11-11,0,0,0,NA
1953,1953-11-12,0,0,0,NA
1953,1953-11-15,0,0,0,NA
1953,1953-11-16,0,0,0,NA
1953,1953-11-17,0,0,0,NA
1953,1953-11-18,0,0,0,NA
1953,1953-11-19,0,0,0,NA
1953,1953-11-20,0,1,-1,-100
1953,1953-11-21,0,0,0,NA
1953,1953-11-22,0,0,0,NA
1953,1953-11-23,0,0,0,NA
1953,1953-11-24,0,0,0,NA
1953,1953-11-26,0,1,-1,-100
1953,1953-11-27,0,2,-2,-100
1953,1953-11-28,0,1,-1,-100
1953,1953-11-29,0,0,0,NA
1953,1953-11-30,0,0,0,NA
1953,1953-12-01,0,0,0,NA
1953,1953-12-02,0,0,0,NA
1953,1953-12-03,0,0,0,NA
1953,1953-12-04,0,0,0,NA
1953,1953-12-05,0,0,0,NA
1953,1953-12-06,0,4,-4,-100
1953,1953-12-07,8,6,2,33.33
1953,1953-12-08,0,1,-1,-100
1953,1953-12-09,0,0,0,NA
1953,1953-12-10,0,0,0,NA
1953,1953-12-11,0,0,0,NA
1953,1953-12-12,0,0,0,NA
1953,1953-12-13,0,0,0,NA
1953,1953-12-14,0,0,0,NA
1953,1953-12-15,0,0,0,NA
1953,1953-12-16,0,0,0,NA
1953,1953-12-17,0,0,0,NA
1953,1953-12-18,0,0,0,NA
1953,1953-12-19,0,0,0,NA
1953,1953-12-20,0,0,0,NA
1953,1953-12-21,0,1,-1,-100
1953,1953-12-22,0,0,0,NA
1953,1953-12-23,0,0,0,NA
1953,1953-12-24,12,3,9,300
1953,1953-12-25,0,7,-7,-100
1953,1953-12-26,14,3,11,366.67
1953,1953-12-27,0,1,-1,-100
1953,1953-12-31,0,0,0,NA
1954,1954-01-01,0,0,0,NA
1954,1954-01-02,0,0,0,NA
1954,1954-01-03,0,0,0,NA
1954,1954-01-04,0,0,0,NA
1954,1954-01-05,0,0,0,NA
1954,1954-01-06,0,0,0,NA
1954,1954-01-07,0,0,0,NA
1954,1954-01-08,0,0,0,NA
1954,1954-01-10,0,0,0,NA
1954,1954-01-12,0,0,0,NA
1954,1954-01-13,0,0,0,NA
1954,1954-01-14,0,0,0,NA
1954,1954-01-15,0,0,0,NA
1954,1954-01-16,0,0,0,NA
1954,1954-01-17,0,0,0,NA
1954,1954-01-21,0,0,0,NA
1954,1954-01-22,0,0,0,NA
1954,1954-01-23,0,0,0,NA
1954,1954-01-25,0,0,0,NA
1954,1954-01-26,0,0,0,NA
1954,1954-01-27,0,0,0,NA
1954,1954-01-28,0,0,0,NA
1954,1954-01-29,0,0,0,NA
1954,1954-01-30,0,0,0,NA
1954,1954-01-31,0,0,0,NA
1954,1954-02-01,0,0,0,NA
1954,1954-02-02,0,0,0,NA
1954,1954-02-03,0,0,0,NA
1954,1954-02-04,0,0,0,NA
1954,1954-02-05,0,0,0,NA
1954,1954-02-06,0,0,0,NA
1954,1954-02-07,0,0,0,NA
1954,1954-02-08,0,3,-3,-100
1954,1954-02-09,0,6,-6,-100
1954,1954-02-10,0,0,0,NA
1954,1954-02-11,0,0,0,NA
1954,1954-02-12,0,0,0,NA
1954,1954-02-14,0,0,0,NA
1954,1954-02-15,0,0,0,NA
1954,1954-02-16,6,0,6,NA
1954,1954-02-17,0,0,0,NA
1954,1954-02-18,0,0,0,NA
1954,1954-02-19,0,0,0,NA
1954,1954-02-20,0,0,0,NA
1954,1954-02-21,0,0,0,NA
1954,1954-02-22,0,0,0,NA
1954,1954-02-23,0,0,0,NA
1954,1954-02-24,0,0,0,NA
1954,1954-02-25,0,0,0,NA
1954,1954-02-26,0,0,0,NA
1954,1954-02-27,0,0,0,NA
1954,1954-02-28,0,0,0,NA
1954,1954-03-01,17,10,7,70
1954,1954-03-02,14,8,6,75
1954,1954-03-04,0,1,-1,-100
1954,1954-03-05,0,0,0,NA
1954,1954-03-06,0,0,0,NA
1954,1954-03-07,0,0,0,NA
1954,1954-03-09,0,0,0,NA
1954,1954-03-10,0,0,0,NA
1954,1954-03-11,0,0,0,NA
1954,1954-03-12,15,8,7,87.5
1954,1954-03-13,28,19,9,47.37
1954,1954-03-14,33,24,9,37.5
1954,1954-03-15,72,26,46,176.92
1954,1954-03-16,39,26,13,50
1954,1954-03-17,37,24,13,54.17
1954,1954-03-18,41,26,15,57.69
1954,1954-03-19,25,19,6,31.58
1954,1954-03-20,20,17,3,17.65
1954,1954-03-21,19,15,4,26.67
1954,1954-03-22,13,10,3,30
1954,1954-03-24,11,5,6,120
1954,1954-03-25,0,1,-1,-100
1954,1954-03-26,0,0,0,NA
1954,1954-03-27,0,0,0,NA
1954,1954-03-28,0,0,0,NA
1954,1954-03-30,0,0,0,NA
1954,1954-03-31,0,0,0,NA
1954,1954-04-01,0,0,0,NA
1954,1954-04-02,0,0,0,NA
1954,1954-04-03,0,0,0,NA
1954,1954-04-04,0,0,0,NA
1954,1954-04-05,0,0,0,NA
1954,1954-04-06,11,0,11,NA
1954,1954-04-07,12,2,10,500
1954,1954-04-08,11,5,6,120
1954,1954-04-09,6,2,4,200
1954,1954-04-10,6,0,6,NA
1954,1954-04-11,6,0,6,NA
1954,1954-04-12,0,0,0,NA
1954,1954-04-13,0,0,0,NA
1954,1954-04-14,22,1,21,2100
1954,1954-04-15,0,3,-3,-100
1954,1954-04-16,12,3,9,300
1954,1954-04-17,0,1,-1,-100
1954,1954-04-18,0,2,-2,-100
1954,1954-04-19,0,0,0,NA
1954,1954-04-20,0,0,0,NA
1954,1954-04-21,0,0,0,NA
1954,1954-04-22,0,0,0,NA
1954,1954-04-23,0,0,0,NA
1954,1954-04-24,0,0,0,NA
1954,1954-04-25,0,0,0,NA
1954,1954-04-26,0,0,0,NA
1954,1954-04-28,0,0,0,NA
1954,1954-04-30,0,0,0,NA
1954,1954-05-01,0,0,0,NA
1954,1954-05-02,0,0,0,NA
1954,1954-05-03,0,0,0,NA
1954,1954-05-04,0,0,0,NA
1954,1954-05-05,0,1,-1,-100
1954,1954-05-06,0,0,0,NA
1954,1954-05-07,0,0,0,NA
1954,1954-05-09,0,0,0,NA
1954,1954-05-10,0,0,0,NA
1954,1954-05-11,0,0,0,NA
1954,1954-05-12,0,0,0,NA
1954,1954-05-13,0,0,0,NA
1954,1954-05-14,11,4,7,175
1954,1954-05-15,0,1,-1,-100
1954,1954-05-16,0,0,0,NA
1954,1954-05-18,0,0,0,NA
1954,1954-05-19,0,0,0,NA
1954,1954-05-20,0,0,0,NA
1954,1954-05-21,0,0,0,NA
1954,1954-05-22,0,0,0,NA
1954,1954-05-23,0,0,0,NA
1954,1954-05-24,0,0,0,NA
1954,1954-05-25,0,0,0,NA
1954,1954-05-26,0,0,0,NA
1954,1954-05-27,0,0,0,NA
1954,1954-05-28,0,0,0,NA
1954,1954-05-29,0,0,0,NA
1954,1954-05-30,0,0,0,NA
1954,1954-05-31,0,0,0,NA
1954,1954-06-01,0,2,-2,-100
1954,1954-06-02,0,1,-1,-100
1954,1954-06-03,0,0,0,NA
1954,1954-06-04,0,0,0,NA
1954,1954-06-05,0,0,0,NA
1954,1954-06-06,0,0,0,NA
1954,1954-06-07,0,0,0,NA
1954,1954-06-08,0,0,0,NA
1954,1954-06-09,0,0,0,NA
1954,1954-06-10,11,0,11,NA
1954,1954-06-11,0,0,0,NA
1954,1954-06-12,0,0,0,NA
1954,1954-06-13,0,0,0,NA
1954,1954-06-14,0,0,0,NA
1954,1954-06-15,0,0,0,NA
1954,1954-06-17,0,0,0,NA
1954,1954-06-18,0,0,0,NA
1954,1954-06-19,0,0,0,NA
1954,1954-06-20,0,0,0,NA
1954,1954-06-21,0,0,0,NA
1954,1954-06-22,0,1,-1,-100
1954,1954-06-24,0,0,0,NA
1954,1954-06-26,0,0,0,NA
1954,1954-06-27,0,0,0,NA
1954,1954-06-28,0,0,0,NA
1954,1954-06-30,0,0,0,NA
1954,1954-07-02,0,0,0,NA
1954,1954-07-03,0,0,0,NA
1954,1954-07-05,0,0,0,NA
1954,1954-07-06,0,0,0,NA
1954,1954-07-09,0,1,-1,-100
1954,1954-07-10,0,0,0,NA
1954,1954-07-11,0,0,0,NA
1954,1954-07-12,16,4,12,300
1954,1954-07-13,16,10,6,60
1954,1954-07-14,13,9,4,44.44
1954,1954-07-15,11,5,6,120
1954,1954-07-16,19,5,14,280
1954,1954-07-17,12,8,4,50
1954,1954-07-18,0,3,-3,-100
1954,1954-07-19,0,0,0,NA
1954,1954-07-20,0,0,0,NA
1954,1954-07-21,0,0,0,NA
1954,1954-07-22,0,0,0,NA
1954,1954-07-23,0,0,0,NA
1954,1954-07-24,12,3,9,300
1954,1954-07-25,8,7,1,14.29
1954,1954-07-26,14,3,11,366.67
1954,1954-07-27,6,0,6,NA
1954,1954-07-28,0,0,0,NA
1954,1954-07-29,6,0,6,NA
1954,1954-07-30,0,1,-1,-100
1954,1954-07-31,0,0,0,NA
1954,1954-08-01,13,5,8,160
1954,1954-08-02,12,12,0,0
1954,1954-08-03,13,13,0,0
1954,1954-08-04,22,12,10,83.33
1954,1954-08-05,28,15,13,86.67
1954,1954-08-06,22,20,2,10
1954,1954-08-07,20,16,4,25
1954,1954-08-08,0,4,-4,-100
1954,1954-08-09,20,15,5,33.33
1954,1954-08-10,23,17,6,35.29
1954,1954-08-11,18,17,1,5.88
1954,1954-08-12,16,13,3,23.08
1954,1954-08-13,7,8,-1,-12.5
1954,1954-08-14,0,1,-1,-100
1954,1954-08-15,0,0,0,NA
1954,1954-08-16,0,0,0,NA
1954,1954-08-17,0,0,0,NA
1954,1954-08-18,0,0,0,NA
1954,1954-08-19,0,0,0,NA
1954,1954-08-20,0,1,-1,-100
1954,1954-08-21,19,16,3,18.75
1954,1954-08-22,28,19,9,47.37
1954,1954-08-23,22,19,3,15.79
1954,1954-08-24,16,15,1,6.67
1954,1954-08-25,12,10,2,20
1954,1954-08-27,0,2,-2,-100
1954,1954-08-28,0,0,0,NA
1954,1954-08-29,0,0,0,NA
1954,1954-08-31,0,0,0,NA
1954,1954-09-01,0,0,0,NA
1954,1954-09-02,0,0,0,NA
1954,1954-09-03,0,0,0,NA
1954,1954-09-04,6,2,4,200
1954,1954-09-05,6,2,4,200
1954,1954-09-06,0,1,-1,-100
1954,1954-09-07,0,0,0,NA
1954,1954-09-08,0,0,0,NA
1954,1954-09-09,0,0,0,NA
1954,1954-09-10,0,0,0,NA
1954,1954-09-11,0,0,0,NA
1954,1954-09-12,0,0,0,NA
1954,1954-09-13,0,0,0,NA
1954,1954-09-14,0,1,-1,-100
1954,1954-09-15,0,1,-1,-100
1954,1954-09-16,0,0,0,NA
1954,1954-09-17,0,0,0,NA
1954,1954-09-18,0,0,0,NA
1954,1954-09-19,0,0,0,NA
1954,1954-09-20,0,0,0,NA
1954,1954-09-21,0,0,0,NA
1954,1954-09-22,0,0,0,NA
1954,1954-09-23,0,0,0,NA
1954,1954-09-24,0,0,0,NA
1954,1954-09-25,0,0,0,NA
1954,1954-09-26,0,0,0,NA
1954,1954-09-27,0,0,0,NA
1954,1954-09-28,0,0,0,NA
1954,1954-09-29,0,0,0,NA
1954,1954-09-30,0,1,-1,-100
1954,1954-10-01,0,0,0,NA
1954,1954-10-02,0,0,0,NA
1954,1954-10-03,0,2,-2,-100
1954,1954-10-04,0,3,-3,-100
1954,1954-10-05,0,2,-2,-100
1954,1954-10-06,0,2,-2,-100
1954,1954-10-07,0,0,0,NA
1954,1954-10-08,6,3,3,100
1954,1954-10-09,12,1,11,1100
1954,1954-10-10,0,0,0,NA
1954,1954-10-11,6,3,3,100
1954,1954-10-12,7,5,2,40
1954,1954-10-13,13,7,6,85.71
1954,1954-10-14,11,12,-1,-8.33
1954,1954-10-15,23,19,4,21.05
1954,1954-10-16,30,15,15,100
1954,1954-10-17,12,1,11,1100
1954,1954-10-18,6,2,4,200
1954,1954-10-19,17,8,9,112.5
1954,1954-10-20,23,8,15,187.5
1954,1954-10-21,11,8,3,37.5
1954,1954-10-22,12,11,1,9.09
1954,1954-10-23,11,10,1,10
1954,1954-10-24,11,9,2,22.22
1954,1954-10-25,11,9,2,22.22
1954,1954-10-26,0,7,-7,-100
1954,1954-10-27,0,0,0,NA
1954,1954-10-28,0,0,0,NA
1954,1954-10-29,0,0,0,NA
1954,1954-10-30,0,0,0,NA
1954,1954-10-31,0,0,0,NA
1954,1954-11-01,0,1,-1,-100
1954,1954-11-02,0,1,-1,-100
1954,1954-11-03,0,0,0,NA
1954,1954-11-04,0,0,0,NA
1954,1954-11-05,0,5,-5,-100
1954,1954-11-06,14,7,7,100
1954,1954-11-07,13,8,5,62.5
1954,1954-11-08,6,7,-1,-14.29
1954,1954-11-09,34,24,10,41.67
1954,1954-11-10,40,40,0,0
1954,1954-11-11,52,35,17,48.57
1954,1954-11-12,51,42,9,21.43
1954,1954-11-13,41,32,9,28.12
1954,1954-11-14,14,19,-5,-26.32
1954,1954-11-15,14,12,2,16.67
1954,1954-11-16,0,2,-2,-100
1954,1954-11-17,0,0,0,NA
1954,1954-11-18,0,0,0,NA
1954,1954-11-19,0,2,-2,-100
1954,1954-11-20,0,0,0,NA
1954,1954-11-21,0,0,0,NA
1954,1954-11-22,0,0,0,NA
1954,1954-11-23,0,0,0,NA
1954,1954-11-24,0,0,0,NA
1954,1954-11-26,6,0,6,NA
1954,1954-11-27,0,0,0,NA
1954,1954-11-28,0,0,0,NA
1954,1954-11-30,0,0,0,NA
1954,1954-12-01,0,0,0,NA
1954,1954-12-02,0,0,0,NA
1954,1954-12-03,0,1,-1,-100
1954,1954-12-04,0,3,-3,-100
1954,1954-12-05,0,1,-1,-100
1954,1954-12-07,0,3,-3,-100
1954,1954-12-08,0,0,0,NA
1954,1954-12-09,0,0,0,NA
1954,1954-12-10,0,0,0,NA
1954,1954-12-11,0,1,-1,-100
1954,1954-12-12,0,0,0,NA
1954,1954-12-13,0,0,0,NA
1954,1954-12-14,0,3,-3,-100
1954,1954-12-15,32,18,14,77.78
1954,1954-12-16,23,17,6,35.29
1954,1954-12-17,20,19,1,5.26
1954,1954-12-18,36,26,10,38.46
1954,1954-12-19,29,19,10,52.63
1954,1954-12-20,23,16,7,43.75
1954,1954-12-21,12,5,7,140
1954,1954-12-22,11,5,6,120
1954,1954-12-23,13,14,-1,-7.14
1954,1954-12-24,13,12,1,8.33
1954,1954-12-25,12,8,4,50
1954,1954-12-26,6,5,1,20
1954,1954-12-27,0,0,0,NA
1954,1954-12-28,0,5,-5,-100
1954,1954-12-29,17,14,3,21.43
1954,1954-12-30,23,21,2,9.52
1954,1954-12-31,25,22,3,13.64
1955,1955-01-01,27,21,6,28.57
1955,1955-01-02,20,16,4,25
1955,1955-01-03,15,16,-1,-6.25
1955,1955-01-04,33,29,4,13.79
1955,1955-01-05,45,37,8,21.62
1955,1955-01-07,69,57,12,21.05
1955,1955-01-08,76,47,29,61.7
1955,1955-01-10,36,28,8,28.57
1955,1955-01-11,38,32,6,18.75
1955,1955-01-12,34,31,3,9.68
1955,1955-01-13,32,28,4,14.29
1955,1955-01-14,18,17,1,5.88
1955,1955-01-15,16,16,0,0
1955,1955-01-16,21,17,4,23.53
1955,1955-01-17,18,14,4,28.57
1955,1955-01-18,12,11,1,9.09
1955,1955-01-19,12,10,2,20
1955,1955-01-20,6,4,2,50
1955,1955-01-21,6,8,-2,-25
1955,1955-01-22,11,9,2,22.22
1955,1955-01-23,23,22,1,4.55
1955,1955-01-24,30,22,8,36.36
1955,1955-01-25,19,15,4,26.67
1955,1955-01-26,24,25,-1,-4
1955,1955-01-27,24,26,-2,-7.69
1955,1955-01-28,11,16,-5,-31.25
1955,1955-01-29,11,13,-2,-15.38
1955,1955-01-30,34,21,13,61.9
1955,1955-01-31,24,22,2,9.09
1955,1955-02-01,23,25,-2,-8
1955,1955-02-02,34,33,1,3.03
1955,1955-02-03,36,40,-4,-10
1955,1955-02-04,42,35,7,20
1955,1955-02-05,38,28,10,35.71
1955,1955-02-06,33,31,2,6.45
1955,1955-02-07,44,36,8,22.22
1955,1955-02-08,39,27,12,44.44
1955,1955-02-09,47,26,21,80.77
1955,1955-02-10,35,30,5,16.67
1955,1955-02-11,33,29,4,13.79
1955,1955-02-12,49,28,21,75
1955,1955-02-13,28,15,13,86.67
1955,1955-02-14,17,13,4,30.77
1955,1955-02-15,11,11,0,0
1955,1955-02-16,26,11,15,136.36
1955,1955-02-18,0,0,0,NA
1955,1955-02-19,0,0,0,NA
1955,1955-02-20,0,0,0,NA
1955,1955-02-21,13,12,1,8.33
1955,1955-02-22,25,19,6,31.58
1955,1955-02-23,25,27,-2,-7.41
1955,1955-02-24,35,27,8,29.63
1955,1955-02-25,37,29,8,27.59
1955,1955-02-26,32,31,1,3.23
1955,1955-02-27,36,33,3,9.09
1955,1955-02-28,31,36,-5,-13.89
1955,1955-03-01,25,29,-4,-13.79
1955,1955-03-02,25,22,3,13.64
1955,1955-03-03,24,19,5,26.32
1955,1955-03-05,12,10,2,20
1955,1955-03-06,11,10,1,10
1955,1955-03-07,0,3,-3,-100
1955,1955-03-08,0,3,-3,-100
1955,1955-03-09,0,2,-2,-100
1955,1955-03-11,0,0,0,NA
1955,1955-03-12,0,0,0,NA
1955,1955-03-13,0,0,0,NA
1955,1955-03-14,0,0,0,NA
1955,1955-03-15,0,0,0,NA
1955,1955-03-17,0,0,0,NA
1955,1955-03-18,0,0,0,NA
1955,1955-03-19,0,0,0,NA
1955,1955-03-20,0,0,0,NA
1955,1955-03-21,0,2,-2,-100
1955,1955-03-22,0,0,0,NA
1955,1955-03-23,0,0,0,NA
1955,1955-03-24,0,0,0,NA
1955,1955-03-25,0,0,0,NA
1955,1955-03-26,0,0,0,NA
1955,1955-03-27,0,2,-2,-100
1955,1955-03-28,0,0,0,NA
1955,1955-03-29,18,6,12,200
1955,1955-03-30,14,13,1,7.69
1955,1955-03-31,15,12,3,25
1955,1955-04-01,14,12,2,16.67
1955,1955-04-02,6,2,4,200
1955,1955-04-03,12,6,6,100
1955,1955-04-04,11,7,4,57.14
1955,1955-04-05,25,21,4,19.05
1955,1955-04-06,34,32,2,6.25
1955,1955-04-07,36,29,7,24.14
1955,1955-04-08,37,26,11,42.31
1955,1955-04-09,13,15,-2,-13.33
1955,1955-04-10,13,9,4,44.44
1955,1955-04-11,6,3,3,100
1955,1955-04-12,0,0,0,NA
1955,1955-04-13,0,1,-1,-100
1955,1955-04-14,0,0,0,NA
1955,1955-04-15,13,13,0,0
1955,1955-04-16,23,13,10,76.92
1955,1955-04-17,11,5,6,120
1955,1955-04-18,0,0,0,NA
1955,1955-04-19,0,0,0,NA
1955,1955-04-20,0,3,-3,-100
1955,1955-04-22,0,1,-1,-100
1955,1955-04-23,0,1,-1,-100
1955,1955-04-24,0,1,-1,-100
1955,1955-04-25,0,0,0,NA
1955,1955-04-26,0,2,-2,-100
1955,1955-04-27,25,14,11,78.57
1955,1955-04-28,28,21,7,33.33
1955,1955-04-29,32,25,7,28
1955,1955-04-30,34,26,8,30.77
1955,1955-05-01,29,28,1,3.57
1955,1955-05-02,26,25,1,4
1955,1955-05-03,43,32,11,34.38
1955,1955-05-04,65,47,18,38.3
1955,1955-05-05,37,35,2,5.71
1955,1955-05-06,38,31,7,22.58
1955,1955-05-07,27,23,4,17.39
1955,1955-05-08,12,8,4,50
1955,1955-05-09,11,0,11,NA
1955,1955-05-10,0,1,-1,-100
1955,1955-05-11,0,0,0,NA
1955,1955-05-12,0,0,0,NA
1955,1955-05-13,0,1,-1,-100
1955,1955-05-14,11,0,11,NA
1955,1955-05-15,0,7,-7,-100
1955,1955-05-16,14,6,8,133.33
1955,1955-05-17,17,17,0,0
1955,1955-05-18,31,24,7,29.17
1955,1955-05-19,38,29,9,31.03
1955,1955-05-20,33,40,-7,-17.5
1955,1955-05-21,65,48,17,35.42
1955,1955-05-24,52,44,8,18.18
1955,1955-05-25,73,44,29,65.91
1955,1955-05-26,52,46,6,13.04
1955,1955-05-27,36,33,3,9.09
1955,1955-05-28,62,36,26,72.22
1955,1955-05-29,45,34,11,32.35
1955,1955-05-30,28,24,4,16.67
1955,1955-05-31,20,20,0,0
1955,1955-06-01,20,15,5,33.33
1955,1955-06-02,22,16,6,37.5
1955,1955-06-03,22,9,13,144.44
1955,1955-06-04,28,16,12,75
1955,1955-06-05,30,19,11,57.89
1955,1955-06-06,26,20,6,30
1955,1955-06-07,31,20,11,55
1955,1955-06-08,28,18,10,55.56
1955,1955-06-09,50,18,32,177.78
1955,1955-06-10,36,23,13,56.52
1955,1955-06-11,56,40,16,40
1955,1955-06-12,36,32,4,12.5
1955,1955-06-14,39,36,3,8.33
1955,1955-06-15,54,34,20,58.82
1955,1955-06-16,74,51,23,45.1
1955,1955-06-17,83,48,35,72.92
1955,1955-06-18,72,49,23,46.94
1955,1955-06-19,73,51,22,43.14
1955,1955-06-20,69,53,16,30.19
1955,1955-06-21,51,34,17,50
1955,1955-06-22,30,21,9,42.86
1955,1955-06-23,13,9,4,44.44
1955,1955-06-24,0,0,0,NA
1955,1955-06-25,0,0,0,NA
1955,1955-06-26,0,0,0,NA
1955,1955-06-27,0,0,0,NA
1955,1955-06-28,15,6,9,150
1955,1955-06-29,13,12,1,8.33
1955,1955-06-30,29,18,11,61.11
1955,1955-07-01,46,35,11,31.43
1955,1955-07-02,51,42,9,21.43
1955,1955-07-03,61,42,19,45.24
1955,1955-07-04,67,46,21,45.65
1955,1955-07-05,72,45,27,60
1955,1955-07-06,67,51,16,31.37
1955,1955-07-07,69,55,14,25.45
1955,1955-07-08,64,42,22,52.38
1955,1955-07-09,45,32,13,40.62
1955,1955-07-10,73,35,38,108.57
1955,1955-07-11,29,18,11,61.11
1955,1955-07-12,16,21,-5,-23.81
1955,1955-07-13,39,27,12,44.44
1955,1955-07-14,34,28,6,21.43
1955,1955-07-15,18,20,-2,-10
1955,1955-07-16,11,10,1,10
1955,1955-07-17,0,7,-7,-100
1955,1955-07-18,0,1,-1,-100
1955,1955-07-19,36,25,11,44
1955,1955-07-20,20,27,-7,-25.93
1955,1955-07-21,14,14,0,0
1955,1955-07-22,14,11,3,27.27
1955,1955-07-23,0,0,0,NA
1955,1955-07-24,0,0,0,NA
1955,1955-07-25,0,1,-1,-100
1955,1955-07-26,6,2,4,200
1955,1955-07-27,15,10,5,50
1955,1955-07-28,17,12,5,41.67
1955,1955-07-29,28,17,11,64.71
1955,1955-07-30,34,22,12,54.55
1955,1955-07-31,26,21,5,23.81
1955,1955-08-01,23,23,0,0
1955,1955-08-02,20,10,10,100
1955,1955-08-03,6,5,1,20
1955,1955-08-05,32,25,7,28
1955,1955-08-06,57,43,14,32.56
1955,1955-08-07,73,48,25,52.08
1955,1955-08-08,74,58,16,27.59
1955,1955-08-09,127,78,49,62.82
1955,1955-08-10,106,78,28,35.9
1955,1955-08-12,86,70,16,22.86
1955,1955-08-13,68,53,15,28.3
1955,1955-08-14,55,45,10,22.22
1955,1955-08-15,52,32,20,62.5
1955,1955-08-16,25,30,-5,-16.67
1955,1955-08-17,14,12,2,16.67
1955,1955-08-22,40,20,20,100
1955,1955-08-24,12,4,8,200
1955,1955-08-25,32,16,16,100
1955,1955-08-26,52,26,26,100
1955,1955-08-27,66,54,12,22.22
1955,1955-08-28,69,55,14,25.45
1955,1955-08-29,67,59,8,13.56
1955,1955-08-30,67,61,6,9.84
1955,1955-08-31,99,75,24,32
1955,1955-09-01,78,85,-7,-8.24
1955,1955-09-02,103,86,17,19.77
1955,1955-09-03,111,96,15,15.62
1955,1955-09-04,102,92,10,10.87
1955,1955-09-05,94,83,11,13.25
1955,1955-09-06,93,75,18,24
1955,1955-09-07,91,69,22,31.88
1955,1955-09-08,109,78,31,39.74
1955,1955-09-09,83,67,16,23.88
1955,1955-09-10,75,53,22,41.51
1955,1955-09-11,60,38,22,57.89
1955,1955-09-12,40,36,4,11.11
1955,1955-09-13,37,30,7,23.33
1955,1955-09-14,33,27,6,22.22
1955,1955-09-15,65,38,27,71.05
1955,1955-09-16,34,30,4,13.33
1955,1955-09-17,27,35,-8,-22.86
1955,1955-09-18,40,29,11,37.93
1955,1955-09-19,11,28,-17,-60.71
1955,1955-09-20,11,9,2,22.22
1955,1955-09-21,0,3,-3,-100
1955,1955-09-22,0,1,-1,-100
1955,1955-09-23,11,4,7,175
1955,1955-09-24,36,23,13,56.52
1955,1955-09-25,12,15,-3,-20
1955,1955-09-26,15,12,3,25
1955,1955-09-27,27,20,7,35
1955,1955-09-28,15,12,3,25
1955,1955-09-29,16,15,1,6.67
1955,1955-09-30,30,31,-1,-3.23
1955,1955-10-01,43,32,11,34.38
1955,1955-10-02,80,54,26,48.15
1955,1955-10-03,69,69,0,0
1955,1955-10-04,66,68,-2,-2.94
1955,1955-10-05,82,61,21,34.43
1955,1955-10-06,71,53,18,33.96
1955,1955-10-08,92,64,28,43.75
1955,1955-10-09,87,69,18,26.09
1955,1955-10-10,76,61,15,24.59
1955,1955-10-11,92,64,28,43.75
1955,1955-10-12,72,43,29,67.44
1955,1955-10-13,46,36,10,27.78
1955,1955-10-14,0,10,-10,-100
1955,1955-10-15,0,6,-6,-100
1955,1955-10-16,0,0,0,NA
1955,1955-10-17,0,0,0,NA
1955,1955-10-18,0,0,0,NA
1955,1955-10-19,16,15,1,6.67
1955,1955-10-20,27,26,1,3.85
1955,1955-10-21,44,30,14,46.67
1955,1955-10-22,58,47,11,23.4
1955,1955-10-23,63,57,6,10.53
1955,1955-10-24,92,81,11,13.58
1955,1955-10-25,136,95,41,43.16
1955,1955-10-26,117,102,15,14.71
1955,1955-10-27,105,92,13,14.13
1955,1955-10-28,121,97,24,24.74
1955,1955-10-29,163,120,43,35.83
1955,1955-10-30,143,109,34,31.19
1955,1955-10-31,141,107,34,31.78
1955,1955-11-01,126,103,23,22.33
1955,1955-11-02,116,88,28,31.82
1955,1955-11-03,84,66,18,27.27
1955,1955-11-04,76,58,18,31.03
1955,1955-11-05,50,53,-3,-5.66
1955,1955-11-06,61,51,10,19.61
1955,1955-11-07,96,64,32,50
1955,1955-11-08,110,85,25,29.41
1955,1955-11-09,135,105,30,28.57
1955,1955-11-10,178,125,53,42.4
1955,1955-11-11,172,122,50,40.98
1955,1955-11-12,181,121,60,49.59
1955,1955-11-13,104,98,6,6.12
1955,1955-11-14,129,108,21,19.44
1955,1955-11-15,133,108,25,23.15
1955,1955-11-16,88,81,7,8.64
1955,1955-11-17,82,74,8,10.81
1955,1955-11-18,76,71,5,7.04
1955,1955-11-19,88,84,4,4.76
1955,1955-11-20,76,67,9,13.43
1955,1955-11-21,58,54,4,7.41
1955,1955-11-22,47,40,7,17.5
1955,1955-11-23,79,68,11,16.18
1955,1955-11-24,80,68,12,17.65
1955,1955-11-26,96,78,18,23.08
1955,1955-11-27,104,80,24,30
1955,1955-11-29,92,88,4,4.55
1955,1955-11-30,131,95,36,37.89
1955,1955-12-01,108,80,28,35
1955,1955-12-02,75,83,-8,-9.64
1955,1955-12-03,113,71,42,59.15
1955,1955-12-05,148,75,73,97.33
1955,1955-12-07,93,80,13,16.25
1955,1955-12-08,77,67,10,14.93
1955,1955-12-10,87,63,24,38.1
1955,1955-12-11,71,57,14,24.56
1955,1955-12-12,65,60,5,8.33
1955,1955-12-13,76,69,7,10.14
1955,1955-12-14,86,57,29,50.88
1955,1955-12-15,89,75,14,18.67
1955,1955-12-16,82,54,28,51.85
1955,1955-12-17,94,70,24,34.29
1955,1955-12-18,98,63,35,55.56
1955,1955-12-20,121,91,30,32.97
1955,1955-12-21,99,78,21,26.92
1955,1955-12-22,83,62,21,33.87
1955,1955-12-25,40,45,-5,-11.11
1955,1955-12-27,63,64,-1,-1.56
1955,1955-12-28,87,62,25,40.32
1955,1955-12-30,83,63,20,31.75
1955,1955-12-31,53,48,5,10.42
